55 115
1728 7232
153 153 153 153 153 153 153 153 153 153 153 153 153 153 153 153 153 153 153 153 153 153 153 153 193 121 121 121 121 121 192 153 153 153 153 153 153 153 153 153 153 153 153 153 153 153 153 153 153 153 153 153 153 153 153 
153 153 153 153 153 153 153 153 153 153 153 153 153 153 153 153 153 153 153 153 153 153 153 153 119 114 114 114 114 114 118 153 153 153 153 153 153 153 153 153 153 153 153 153 153 153 153 153 153 153 153 153 153 153 153 
153 153 153 153 153 153 153 153 153 153 153 153 153 153 153 153 153 153 153 153 153 153 153 153 119 114 114 114 114 114 118 153 153 153 153 153 153 153 153 153 153 153 153 153 153 153 153 153 153 153 153 153 153 153 153 
153 153 153 153 153 153 153 153 153 153 153 153 153 153 153 153 153 153 153 153 153 153 153 153 119 114 114 114 114 114 118 153 153 153 153 153 153 153 153 153 153 153 153 153 153 153 153 153 153 153 153 153 153 153 153 
153 153 153 153 153 153 153 153 153 153 153 153 153 153 153 153 153 153 153 153 153 153 153 153 191 116 117 114 115 116 190 153 153 153 153 153 153 153 153 153 153 153 153 153 153 153 153 153 153 153 153 153 153 153 153 
153 153 153 153 153 153 153 153 153 153 153 153 153 153 153 153 153 153 193 121 121 121 121 121 121 121 122 114 120 121 121 121 121 121 121 121 192 153 153 153 153 153 153 153 153 153 153 153 153 153 153 153 153 153 153 
153 153 153 153 153 153 153 153 153 153 153 153 153 153 153 153 153 153 119 114 114 114 114 114 114 114 114 114 114 114 114 114 114 114 114 114 118 153 153 153 153 153 153 153 153 153 153 153 153 153 153 153 153 153 153 
153 153 153 153 153 153 153 153 153 153 153 153 153 153 153 153 153 153 119 114 114 114 114 114 114 114 114 114 114 114 114 114 114 114 114 114 118 153 153 153 153 153 153 153 153 153 153 153 153 153 153 153 153 153 153 
153 153 153 153 153 153 153 153 153 153 153 153 153 153 153 153 153 153 119 114 114 114 114 114 114 114 114 114 114 114 114 114 114 114 114 114 118 153 153 153 153 153 153 153 153 153 153 153 153 153 153 153 153 153 153 
153 153 153 153 153 153 153 153 153 153 153 153 153 153 153 153 153 153 119 114 114 114 114 114 114 114 114 114 114 114 114 114 114 114 114 114 118 153 153 153 153 153 153 153 153 153 153 153 153 153 153 153 153 153 153 
153 153 153 153 153 153 153 153 153 153 153 153 153 153 153 153 153 153 119 114 114 114 114 114 114 114 114 114 114 114 114 114 114 114 114 114 118 153 153 153 153 153 153 153 153 153 153 153 153 153 153 153 153 153 153 
153 153 153 153 153 153 153 153 153 153 153 153 153 153 153 153 153 153 119 114 114 114 114 114 114 114 114 114 114 114 114 114 114 114 114 114 118 153 153 153 153 153 153 153 153 153 153 153 153 153 153 153 153 153 153 
153 153 153 153 153 153 153 153 153 153 153 153 153 153 153 153 153 153 191 116 116 116 116 116 116 116 117 114 115 116 116 116 116 116 116 116 190 153 153 153 153 153 153 153 153 153 153 153 153 153 153 153 153 153 153
153 153 153 153 153 153 153 153 153 153 153 153 153 153 153 153 153 153 193 121 121 121 121 121 121 121 122 114 120 121 121 121 121 121 121 121 192 153 153 153 153 153 153 153 153 153 153 153 153 153 153 153 153 153 153
153 153 153 153 153 153 153 153 153 153 153 153 153 153 153 153 153 153 119 114 114 114 114 114 114 114 114 114 114 114 114 114 114 114 114 114 118 153 153 153 153 153 153 153 153 153 153 153 153 153 153 153 153 153 153
153 153 153 153 153 153 153 153 153 153 153 153 153 153 153 153 153 153 119 114 114 114 114 114 114 114 114 114 114 114 114 114 114 114 114 114 118 153 153 153 153 153 153 153 153 153 153 153 153 153 153 153 153 153 153
153 153 153 153 153 153 153 153 153 153 153 153 153 153 153 153 153 153 119 114 114 114 114 114 114 114 114 114 114 114 114 114 114 114 114 114 118 153 153 153 153 153 153 153 153 153 153 153 153 153 153 153 153 153 153
153 153 153 153 153 153 153 153 153 153 153 153 153 153 153 153 153 153 119 114 114 114 114 114 114 114 114 114 114 114 114 114 114 114 114 114 118 153 153 153 153 153 153 153 153 153 153 153 153 153 153 153 153 153 153
153 153 153 153 153 153 153 153 153 153 153 153 153 153 153 153 153 153 119 114 114 114 114 114 114 114 114 114 114 114 114 114 114 114 114 114 118 153 153 153 153 153 153 153 153 153 153 153 153 153 153 153 153 153 153
153 153 153 153 153 153 153 153 153 153 153 153 153 153 153 153 153 153 119 114 114 114 114 114 114 114 114 114 114 114 114 114 114 114 114 114 118 153 153 153 153 153 153 153 153 153 153 153 153 153 153 153 153 153 153
153 153 153 153 153 153 153 153 153 153 153 153 153 153 153 153 153 153 119 114 114 114 114 114 114 114 114 114 114 114 114 114 114 114 114 114 118 153 153 153 153 153 153 153 153 153 153 153 153 153 153 153 153 153 153
153 153 153 153 153 153 153 153 153 153 153 153 153 153 153 153 153 153 119 114 114 114 114 114 114 114 114 114 114 114 114 114 114 114 114 114 118 153 153 153 153 153 153 153 153 153 153 153 153 153 153 153 153 153 153
153 153 153 153 153 153 153 153 153 153 153 153 153 153 153 153 153 153 119 114 114 114 114 114 114 114 114 114 114 114 114 114 114 114 114 114 118 153 153 153 153 153 153 153 153 153 153 153 153 153 153 153 153 153 153
153 153 153 153 153 153 153 153 153 153 153 153 153 153 153 153 153 153 119 114 114 114 114 114 114 114 114 114 114 114 114 114 114 114 114 114 118 153 153 153 153 153 153 153 153 153 153 153 153 153 153 153 153 153 153
153 153 153 153 153 153 153 153 153 153 153 153 153 153 153 153 153 153 119 114 114 114 114 114 114 114 114 114 114 114 114 114 114 114 114 114 118 153 153 153 153 153 153 153 153 153 153 153 153 153 153 153 153 153 153
153 153 153 153 153 153 153 153 153 153 153 153 153 153 153 153 153 153 119 114 114 114 114 114 114 114 114 114 114 114 114 114 114 114 114 114 118 153 153 153 153 153 153 153 153 153 153 153 153 153 153 153 153 153 153
153 153 153 153 153 153 153 153 153 153 153 153 153 153 153 153 153 153 119 114 114 114 114 114 114 114 114 114 114 114 114 114 114 114 114 114 118 153 153 153 153 153 153 153 153 153 153 153 153 153 153 153 153 153 153
153 153 153 153 153 153 153 153 153 153 153 153 153 153 153 153 153 153 119 114 114 114 114 114 114 114 114 114 114 114 114 114 114 114 114 114 118 153 153 153 153 153 153 153 153 153 153 153 153 153 153 153 153 153 153
153 153 153 153 153 153 153 153 153 153 153 153 153 153 153 153 153 153 191 116 116 116 116 116 116 117 114 114 114 115 116 116 116 116 116 116 190 153 153 153 153 153 153 153 153 153 153 153 153 153 153 153 153 153 153
153 153 153 153 153 153 153 153 153 153 153 153 153 153 153 153 153 153 193 121 121 121 121 121 192 119 114 114 114 118 193 121 121 121 121 121 192 153 153 153 153 153 153 153 153 153 153 153 153 153 153 153 153 153 153
153 153 153 153 153 153 153 153 153 153 153 153 153 153 153 153 153 153 119 114 114 114 114 114 118 119 114 114 114 118 119 114 114 114 114 114 118 153 153 153 153 153 153 153 153 153 153 153 153 153 153 153 153 153 153
153 153 153 153 153 153 153 153 153 153 153 153 153 153 153 153 153 153 119 114 114 114 114 114 120 122 114 114 114 120 122 114 114 114 114 114 118 153 153 153 153 153 153 153 153 153 153 153 153 153 153 153 153 153 153
153 153 153 153 153 153 153 153 153 153 153 153 153 153 153 153 153 153 119 114 114 114 114 114 114 114 114 114 114 114 114 114 114 114 114 114 118 153 153 153 153 153 153 153 153 153 153 153 153 153 153 153 153 153 153
153 153 153 153 153 153 153 153 153 153 153 153 153 153 153 153 153 153 119 114 114 114 114 114 115 117 114 114 114 115 117 114 114 114 114 114 118 153 153 153 153 153 153 153 153 153 153 153 153 153 153 153 153 153 153
153 153 153 153 153 153 153 153 153 153 153 153 153 153 153 153 153 153 119 114 114 114 114 114 118 119 114 114 114 118 119 114 114 114 114 114 118 153 153 153 153 153 153 153 153 153 153 153 153 153 153 153 153 153 153
153 153 153 153 153 153 153 153 153 153 153 153 153 153 153 153 153 153 119 114 114 114 114 114 118 119 114 114 114 118 119 114 114 114 114 114 118 153 153 153 153 153 153 153 153 153 153 153 153 153 153 153 153 153 153
153 153 153 153 153 153 153 153 153 153 153 153 153 153 153 153 153 153 119 114 114 114 114 114 118 119 114 114 114 118 119 114 114 114 114 114 118 153 153 153 153 153 153 153 153 153 153 153 153 153 153 153 153 153 153
153 153 153 153 153 153 153 153 153 153 153 153 153 153 153 153 153 153 119 114 114 114 114 114 118 119 114 114 114 118 119 114 114 114 114 114 118 153 153 153 153 153 153 153 153 153 153 153 153 153 153 153 153 153 153
153 153 153 153 153 153 153 153 153 153 153 153 153 153 153 153 153 153 119 114 114 114 114 115 190 191 116 116 116 190 119 114 114 114 114 114 118 153 153 153 153 153 153 153 153 153 153 153 153 153 153 153 153 153 153
153 153 153 153 153 153 153 153 153 153 153 153 153 153 153 153 153 153 119 114 114 114 114 118 193 121 121 121 121 192 119 114 114 114 114 114 118 153 153 153 153 153 153 153 153 153 153 153 153 153 153 153 153 153 153 
153 153 153 153 153 153 153 153 153 153 153 153 153 153 153 153 153 153 119 114 114 114 114 118 119 114 114 114 152 118 119 114 114 114 114 114 118 153 153 153 153 153 153 153 153 153 153 153 153 153 153 153 153 153 153 
153 153 153 153 153 153 153 153 153 153 153 153 153 153 153 153 153 153 119 114 114 114 114 118 119 114 114 152 114 118 119 114 114 114 114 114 118 153 153 153 153 153 153 153 153 153 153 153 153 153 153 153 153 153 153 
153 153 153 153 153 153 153 153 153 153 153 153 153 153 153 153 153 153 119 114 114 114 114 120 122 114 114 114 114 120 122 114 114 114 114 114 118 153 153 153 153 153 153 153 153 153 153 153 153 153 153 153 153 153 153 
153 153 153 153 153 153 153 153 153 153 153 153 153 153 153 153 153 153 119 114 114 114 114 114 114 114 114 114 114 114 114 114 114 114 114 114 118 153 153 153 153 153 153 153 153 153 153 153 153 153 153 153 153 153 153 
153 153 153 153 153 153 153 153 153 153 153 153 153 153 153 153 153 153 119 114 114 114 114 115 117 114 114 114 114 115 117 114 114 114 114 114 118 153 153 153 153 153 153 153 153 153 153 153 153 153 153 153 153 153 153 
153 153 153 153 153 153 153 153 153 153 153 153 153 153 153 153 153 153 119 114 114 114 114 118 119 114 114 114 114 118 119 114 114 114 114 114 118 153 153 153 153 153 153 153 153 153 153 153 153 153 153 153 153 153 153 
153 153 153 153 153 153 153 153 153 153 153 153 153 153 153 153 153 153 119 114 114 114 114 118 119 114 152 114 114 118 119 114 114 114 114 114 118 153 153 153 153 153 153 153 153 153 153 153 153 153 153 153 153 153 153 
153 153 153 153 153 153 153 153 153 153 153 153 153 153 153 153 153 153 119 114 114 114 114 118 119 152 114 114 114 118 119 114 114 114 114 114 118 153 153 153 153 153 153 153 153 153 153 153 153 153 153 153 153 153 153 
153 153 153 153 153 153 153 153 153 153 153 153 153 153 153 153 153 153 191 116 116 116 116 190 191 116 117 114 115 190 191 116 116 116 116 116 190 153 153 153 153 153 153 153 153 153 153 153 153 153 153 153 153 153 153
153 153 153 153 153 153 153 153 153 153 153 153 153 153 153 153 153 153 153 153 153 153 193 121 121 121 122 114 120 121 121 121 192 153 153 153 153 153 153 153 153 153 153 153 153 153 153 153 153 153 153 153 153 153 153
153 153 153 153 153 153 153 153 153 153 153 153 153 153 153 153 153 153 153 153 153 153 119 114 114 114 114 114 114 114 114 114 118 153 153 153 153 153 153 153 153 153 153 153 153 153 153 153 153 153 153 153 153 153 153
153 153 153 153 153 153 153 153 153 153 153 153 153 153 153 153 153 153 153 153 153 153 119 114 114 114 114 114 114 114 114 114 118 153 153 153 153 153 153 153 153 153 153 153 153 153 153 153 153 153 153 153 153 153 153
153 153 153 153 153 153 153 153 153 153 153 153 153 153 153 153 153 153 153 153 153 153 119 114 114 114 114 114 114 114 114 114 118 153 153 153 153 153 153 153 153 153 153 153 153 153 153 153 153 153 153 153 153 153 153
153 153 153 153 153 153 153 153 153 153 153 153 153 153 153 153 153 153 153 153 153 153 119 114 114 114 114 114 114 114 114 114 118 153 153 153 153 153 153 153 153 153 153 153 153 153 153 153 153 153 153 153 153 153 153
153 153 153 153 153 153 153 153 153 153 153 153 153 153 153 153 153 153 153 153 153 153 119 114 114 114 114 114 114 114 114 114 118 153 153 153 153 153 153 153 153 153 153 153 153 153 153 153 153 153 153 153 153 153 153
153 153 153 153 153 153 153 153 153 153 153 153 153 153 153 153 153 153 153 153 153 153 119 114 114 114 114 114 114 114 114 114 118 153 153 153 153 153 153 153 153 153 153 153 153 153 153 153 153 153 153 153 153 153 153
153 153 153 153 153 153 153 153 153 153 153 153 153 153 153 153 153 153 153 153 153 153 119 114 114 114 114 114 114 114 114 114 118 153 153 153 153 153 153 153 153 153 153 153 153 153 153 153 153 153 153 153 153 153 153
153 153 153 153 153 153 153 153 153 153 153 153 153 153 153 153 153 153 153 153 153 153 119 114 114 114 114 114 114 114 114 114 118 153 153 153 153 153 153 153 153 153 153 153 153 153 153 153 153 153 153 153 153 153 153
153 153 153 153 153 153 153 153 153 153 153 153 153 153 153 153 153 153 153 153 153 153 119 114 114 114 114 114 114 114 114 114 118 153 153 153 153 153 153 153 153 153 153 153 153 153 153 153 153 153 153 153 153 153 153
153 153 153 153 153 153 153 153 153 153 153 153 153 153 153 153 153 153 153 153 153 153 191 116 116 116 117 114 115 116 116 116 190 153 153 153 153 153 153 153 153 153 153 153 153 153 153 153 153 153 153 153 153 153 153
153 153 153 153 153 153 153 153 153 153 153 153 153 153 153 153 153 153 153 153 153 153 193 121 121 121 122 114 120 121 121 121 192 153 153 153 153 153 153 153 153 153 153 153 153 153 153 153 153 153 153 153 153 153 153
153 153 153 153 153 153 153 153 153 153 153 153 153 153 153 153 153 153 153 153 153 153 119 114 114 114 114 114 114 114 114 114 118 153 153 153 153 153 153 153 153 153 153 153 153 153 153 153 153 153 153 153 153 153 153
153 153 153 153 153 153 153 153 153 153 153 153 153 153 153 153 153 153 153 153 153 153 119 114 114 114 114 114 114 114 114 114 118 153 153 153 153 153 153 153 153 153 153 153 153 153 153 153 153 153 153 153 153 153 153
153 153 153 153 153 153 153 153 153 153 153 153 153 153 153 153 153 153 153 153 153 153 119 114 114 114 114 114 114 114 114 114 118 153 153 153 153 153 153 153 153 153 153 153 153 153 153 153 153 153 153 153 153 153 153
153 153 153 153 153 153 153 153 153 153 153 153 153 153 153 153 153 153 153 153 153 153 119 114 114 114 114 114 114 114 114 114 118 153 153 153 153 153 153 153 153 153 153 153 153 153 153 153 153 153 153 153 153 153 153
153 153 153 153 153 153 153 153 153 153 153 153 153 153 153 153 153 153 153 153 153 153 119 114 114 114 114 114 114 114 114 114 118 153 153 153 153 153 153 153 153 153 153 153 153 153 153 153 153 153 153 153 153 153 153
153 153 153 153 153 153 153 153 153 153 153 153 153 153 153 153 153 153 153 153 153 153 119 114 114 114 114 114 114 114 114 114 118 153 153 153 153 153 153 153 153 153 153 153 153 153 153 153 153 153 153 153 153 153 153
153 153 153 153 153 153 153 153 153 153 153 153 153 153 153 153 153 153 153 153 153 153 119 114 114 114 114 114 114 114 114 114 118 153 153 153 153 153 153 153 153 153 153 153 153 153 153 153 153 153 153 153 153 153 153
153 153 153 153 153 153 153 153 153 153 153 153 153 153 153 153 153 153 153 153 153 153 119 114 114 114 114 114 114 114 114 114 118 153 153 153 153 153 153 153 153 153 153 153 153 153 153 153 153 153 153 153 153 153 153
153 153 153 153 153 153 153 153 153 153 153 153 153 153 153 153 153 153 153 153 153 153 119 114 114 114 114 114 114 114 114 114 118 153 153 153 153 153 153 153 153 153 153 153 153 153 153 153 153 153 153 153 153 153 153
153 153 153 153 153 153 153 153 153 153 153 153 153 153 153 153 153 153 153 153 153 153 191 116 116 116 117 114 115 116 116 116 190 153 153 153 153 153 153 153 153 153 153 153 153 153 153 153 153 153 153 153 153 153 153
153 153 153 153 153 153 153 153 153 153 153 193 121 121 121 121 121 121 121 121 121 192 193 121 121 121 122 114 120 121 121 121 192 193 121 121 121 121 121 121 121 121 121 192 153 153 153 153 153 153 153 153 153 153 153
153 153 153 153 153 153 153 153 153 153 153 119 114 114 114 114 114 114 114 114 114 118 119 114 114 114 114 114 114 114 114 114 118 119 114 114 114 114 114 114 114 114 114 118 153 153 153 153 153 153 153 153 153 153 153
153 153 153 153 153 153 153 153 153 153 153 119 114 114 114 114 114 114 114 114 114 118 119 114 114 114 114 114 114 114 114 114 118 119 114 114 114 114 114 114 114 114 114 118 153 153 153 153 153 153 153 153 153 153 153
153 153 153 153 153 153 153 153 153 153 153 119 114 114 114 114 114 114 114 114 114 118 119 114 114 114 114 114 114 114 114 114 118 119 114 114 114 114 114 114 114 114 114 118 153 153 153 153 153 153 153 153 153 153 153
153 153 153 153 153 153 153 153 153 153 153 119 114 114 114 114 114 114 114 114 114 120 122 114 114 114 114 114 114 114 114 114 120 122 114 114 114 114 114 114 114 114 114 118 153 153 153 153 153 153 153 153 153 153 153
153 153 153 153 153 153 153 153 153 153 153 119 114 114 114 114 114 114 114 114 114 114 114 114 114 114 114 114 114 114 114 114 114 114 114 114 114 114 114 114 114 114 114 118 153 153 153 153 153 153 153 153 153 153 153
153 153 153 153 153 153 153 153 153 153 153 119 114 114 114 114 114 114 114 114 114 115 117 114 114 114 114 114 114 114 114 114 115 117 114 114 114 114 114 114 114 114 114 118 153 153 153 153 153 153 153 153 153 153 153
153 153 153 153 153 153 153 153 153 153 153 119 114 114 114 114 114 114 114 114 114 118 119 114 114 114 114 114 114 114 114 114 118 119 114 114 114 114 114 114 114 114 114 118 153 153 153 153 153 153 153 153 153 153 153
153 153 153 153 153 153 153 153 153 153 153 119 114 114 114 114 114 114 114 114 114 118 119 114 114 114 114 114 114 114 114 114 118 119 114 114 114 114 114 114 114 114 114 118 153 153 153 153 153 153 153 153 153 153 153
153 153 153 153 153 153 153 153 153 153 153 119 114 114 114 114 114 114 114 114 114 118 119 114 114 114 114 114 114 114 114 114 118 119 114 114 114 114 114 114 114 114 114 118 153 153 153 153 153 153 153 153 153 153 153
153 153 153 153 153 153 153 153 153 153 153 191 116 116 116 117 114 115 116 116 116 190 191 116 116 116 116 116 116 116 116 116 190 191 116 116 116 117 114 115 116 116 116 190 153 153 153 153 153 153 153 153 153 153 153
193 121 121 121 121 121 121 121 121 121 192 193 121 121 121 122 114 120 121 121 121 192 193 121 121 121 121 121 121 121 121 121 192 193 121 121 121 122 114 120 121 121 121 192 193 121 121 121 121 121 121 121 121 121 192
119 114 114 114 114 114 114 114 114 114 118 119 114 114 114 114 114 114 114 114 114 118 119 114 114 114 114 114 114 114 114 114 118 119 114 114 114 114 114 114 114 114 114 118 119 114 114 114 114 114 114 114 114 114 118
119 114 114 114 114 114 114 114 114 114 118 119 114 114 114 114 114 115 116 117 114 118 119 114 114 114 114 114 114 114 114 114 118 119 114 114 114 114 114 115 116 117 114 118 119 114 114 114 114 114 114 114 114 114 118
119 114 114 114 114 114 114 114 114 114 118 119 114 115 116 117 114 120 121 122 114 118 119 114 114 114 114 114 114 114 114 114 118 119 114 115 116 117 114 120 121 122 114 118 119 114 114 114 114 114 114 114 114 114 118
119 114 114 114 114 114 114 114 114 114 120 122 114 118 153 119 114 114 114 114 114 120 122 114 114 114 114 114 114 114 114 114 120 122 114 118 153 119 114 114 114 114 114 120 122 114 114 114 114 114 114 114 114 114 118
119 114 114 114 114 114 114 114 114 114 114 114 114 120 121 122 114 114 114 114 114 114 114 114 114 114 114 114 114 114 114 114 114 114 114 120 121 122 114 114 114 114 114 114 114 114 114 114 114 114 114 114 114 114 118
119 114 114 114 114 114 114 114 114 114 115 117 114 114 114 114 114 115 116 117 114 115 117 114 114 114 114 114 114 114 114 114 115 117 114 114 114 114 114 115 116 117 114 115 117 114 114 114 114 114 114 114 114 114 118
119 114 114 114 114 114 114 114 114 114 118 119 114 115 116 117 114 118 153 119 114 118 119 114 114 114 114 114 114 114 114 114 118 119 114 115 116 117 114 118 153 119 114 118 119 114 114 114 114 114 114 114 114 114 118
119 114 114 114 114 114 114 114 114 114 118 119 114 120 121 122 114 120 121 122 114 118 119 114 114 114 114 114 114 114 114 114 118 119 114 120 121 122 114 120 121 122 114 118 119 114 114 114 114 114 114 114 114 114 118
119 114 114 114 114 114 114 114 114 114 118 119 114 114 114 114 114 114 114 114 114 118 119 114 114 114 114 114 114 114 114 114 118 119 114 114 114 114 114 114 114 114 114 118 119 114 114 114 114 114 114 114 114 114 118
191 116 116 116 116 116 116 116 116 116 190 191 116 116 116 117 114 115 116 116 116 190 191 116 116 116 116 116 116 116 116 116 190 191 116 116 116 117 114 115 116 116 116 190 191 116 116 116 116 116 116 116 116 116 190
153 153 153 153 153 153 153 153 153 153 153 193 121 121 121 122 114 120 121 121 121 192 193 121 121 121 121 121 121 121 121 121 192 193 121 121 121 122 114 120 121 121 121 192 153 153 153 153 153 153 153 153 153 153 153
153 153 153 153 153 153 153 153 153 153 153 119 114 152 114 114 114 114 114 114 114 118 119 114 114 114 114 114 114 114 114 114 118 119 114 114 114 114 114 114 114 114 114 118 153 153 153 153 153 153 153 153 153 153 153
153 153 153 153 153 153 153 153 153 153 153 119 114 152 114 114 114 114 114 114 114 118 119 114 114 114 114 114 114 114 114 114 118 119 114 114 114 114 114 114 114 114 114 118 153 153 153 153 153 153 153 153 153 153 153
153 153 153 153 153 153 153 153 153 153 153 119 114 152 114 114 114 114 114 114 114 118 119 114 114 114 114 114 114 114 114 114 118 119 114 114 114 114 114 114 114 114 114 118 153 153 153 153 153 153 153 153 153 153 153
153 153 153 153 153 153 153 153 153 153 153 119 114 152 114 114 114 114 114 114 114 120 122 114 114 114 114 114 114 114 114 114 120 122 114 114 114 114 114 114 114 114 114 118 153 153 153 153 153 153 153 153 153 153 153
153 153 153 153 153 153 153 153 153 153 153 119 114 152 114 114 114 114 114 114 114 114 114 114 114 114 114 114 114 114 114 114 114 114 114 114 114 114 114 114 114 114 114 118 153 153 153 153 153 153 153 153 153 153 153
153 153 153 153 153 153 153 153 153 153 153 119 114 152 114 114 114 114 114 114 114 115 117 114 114 114 114 114 114 114 114 114 115 117 114 114 114 114 114 114 114 114 114 118 153 153 153 153 153 153 153 153 153 153 153
153 153 153 153 153 153 153 153 153 153 153 119 114 152 114 114 114 114 114 114 114 118 119 114 114 114 114 114 114 114 114 114 118 119 114 114 114 114 114 114 114 114 114 118 153 153 153 153 153 153 153 153 153 153 153
153 153 153 153 153 153 153 153 153 153 153 119 114 152 114 114 114 114 114 114 114 118 119 114 114 114 114 114 114 114 114 114 118 119 114 114 114 114 114 114 114 114 114 118 153 153 153 153 153 153 153 153 153 153 153
153 153 153 153 153 153 153 153 153 153 153 119 114 152 114 114 114 114 114 114 114 118 119 114 114 114 114 114 114 114 114 114 118 119 114 114 114 114 114 114 114 114 114 118 153 153 153 153 153 153 153 153 153 153 153
153 153 153 153 153 153 153 153 153 153 153 191 116 116 116 116 116 116 116 116 116 190 191 116 116 116 117 114 115 116 116 116 190 191 116 116 116 116 116 116 116 116 116 190 153 153 153 153 153 153 153 153 153 153 153
153 153 153 153 153 153 153 153 153 153 153 153 153 153 153 153 153 153 153 153 153 153 193 121 121 121 122 114 120 121 121 121 192 153 153 153 153 153 153 153 153 153 153 153 153 153 153 153 153 153 153 153 153 153 153
153 153 153 153 153 153 153 153 153 153 153 153 153 153 153 153 153 153 153 153 153 153 119 114 152 114 114 114 114 114 114 114 118 153 153 153 153 153 153 153 153 153 153 153 153 153 153 153 153 153 153 153 153 153 153
153 153 153 153 153 153 153 153 153 153 153 153 153 153 153 153 153 153 153 153 153 153 119 114 152 114 114 114 114 114 114 114 118 153 153 153 153 153 153 153 153 153 153 153 153 153 153 153 153 153 153 153 153 153 153
153 153 153 153 153 153 153 153 153 153 153 153 153 153 153 153 153 153 153 153 153 153 119 114 152 114 114 114 114 114 114 114 118 153 153 153 153 153 153 153 153 153 153 153 153 153 153 153 153 153 153 153 153 153 153
153 153 153 153 153 153 153 153 153 153 153 153 153 153 153 153 153 153 153 153 153 153 119 114 152 114 114 114 114 114 114 114 118 153 153 153 153 153 153 153 153 153 153 153 153 153 153 153 153 153 153 153 153 153 153
153 153 153 153 153 153 153 153 153 153 153 153 153 153 153 153 153 153 153 153 153 153 119 114 152 114 114 114 114 114 114 114 118 153 153 153 153 153 153 153 153 153 153 153 153 153 153 153 153 153 153 153 153 153 153
153 153 153 153 153 153 153 153 153 153 153 153 153 153 153 153 153 153 153 153 153 153 119 114 152 114 114 114 114 114 114 114 118 153 153 153 153 153 153 153 153 153 153 153 153 153 153 153 153 153 153 153 153 153 153
153 153 153 153 153 153 153 153 153 153 153 153 153 153 153 153 153 153 153 153 153 153 119 114 152 114 114 114 114 114 114 114 118 153 153 153 153 153 153 153 153 153 153 153 153 153 153 153 153 153 153 153 153 153 153
153 153 153 153 153 153 153 153 153 153 153 153 153 153 153 153 153 153 153 153 153 153 119 114 152 114 114 114 114 114 114 114 118 153 153 153 153 153 153 153 153 153 153 153 153 153 153 153 153 153 153 153 153 153 153
153 153 153 153 153 153 153 153 153 153 153 153 153 153 153 153 153 153 153 153 153 153 119 114 152 114 114 114 114 114 114 114 118 153 153 153 153 153 153 153 153 153 153 153 153 153 153 153 153 153 153 153 153 153 153
153 153 153 153 153 153 153 153 153 153 153 153 153 153 153 153 153 153 153 153 153 153 191 116 116 116 116 114 116 116 116 116 190 153 153 153 153 153 153 153 153 153 153 153 153 153 153 153 153 153 153 153 153 153 153191