56 80
320 4992

153 153 153 153 153 153 153 153 153 153 153 121 121 121 121 121 121 121 121 121 121 121 121 121 121 121 153 153 121 121 121 121 121 121 121 121 153 153 153 153 153 153 153 153 153 153 153 153 153 153 153 153 153 153 153 153
153 153 153 153 153 153 153 153 153 153 119 123 183 183 183 183 183 183 183 183 183 183 183 183 183 183 118 119 183 183 152 183 183 152 152 183 118 153 153 153 153 153 153 153 153 153 153 153 153 153 153 153 153 153 153 153
153 153 153 153 153 153 153 153 153 153 119 183 183 183 183 183 183 183 183 183 183 183 183 183 183 152 118 119 183 183 152 183 183 183 183 183 118 153 153 153 153 153 153 153 153 153 153 153 153 153 153 153 153 153 153 153
153 153 153 153 153 153 153 153 153 153 119 183 183 183 183 183 183 183 183 183 183 183 183 183 183 152 152 152 152 152 152 152 152 183 183 183 118 153 153 153 153 153 153 153 153 153 153 153 153 153 153 153 153 153 153 153
153 153 153 153 153 153 153 153 153 153 119 183 183 183 183 183 183 183 183 183 183 183 183 183 183 152 120 122 152 152 152 152 183 183 183 152 118 153 153 153 153 153 153 153 153 153 153 153 153 153 153 153 153 153 153 153
153 153 153 153 153 153 153 153 153 153 119 183 183 183 183 183 183 183 183 183 183 183 183 183 183 183 183 183 152 152 152 152 152 183 183 183 118 153 153 153 153 153 153 153 153 153 153 153 153 153 153 153 153 153 153 153
153 153 153 153 153 153 153 153 153 153 119 183 183 183 183 183 183 183 183 183 183 183 183 183 183 183 115 117 152 152 152 152 183 183 183 183 118 153 153 153 153 153 153 153 153 153 153 153 153 153 153 153 153 153 153 153
153 153 153 153 153 153 153 153 153 153 119 183 183 183 183 183 183 183 183 183 183 183 183 183 183 183 118 153 116 116 116 116 116 116 117 183 118 153 153 153 153 153 153 153 153 153 153 153 153 153 153 153 153 153 153 153
153 153 153 153 153 153 153 153 153 153 119 183 183 183 183 183 183 183 183 183 115 116 116 116 116 116 153 153 153 153 153 153 153 153 119 183 118 153 104 105 104 105 104 105 104 105 106 153 153 153 153 153 153 153 153 153
153 153 153 153 153 153 153 153 153 153 119 183 183 183 183 183 183 115 116 116 153 153 121 121 121 121 121 121 121 121 121 121 121 121 122 000 120 122 106 107 106 107 106 107 106 107 104 153 153 153 153 153 153 153 153 153
153 153 153 153 153 153 153 153 153 153 153 116 116 116 116 117 183 120 121 121 152 119 000 000 000 000 000 000 000 000 000 000 000 000 000 000 000 000 000 000 000 000 000 000 000 000 106 153 153 153 153 153 153 153 153 153
153 153 153 153 153 153 153 153 153 153 153 121 121 121 121 122 183 183 152 152 152 119 000 000 000 000 000 000 000 000 000 000 000 000 000 000 000 000 000 000 000 000 000 000 000 000 104 153 153 153 153 153 153 153 153 153
153 153 153 153 153 153 153 153 153 153 119 183 183 183 183 183 183 183 152 152 118 119 000 000 000 000 000 000 000 000 000 000 000 000 000 000 000 000 000 000 000 000 000 000 000 000 106 153 153 153 153 153 153 153 153 153
153 153 153 153 153 153 153 153 153 153 119 183 183 183 183 183 183 183 183 183 118 119 000 000 000 000 000 000 000 000 000 000 000 000 000 000 000 000 000 000 000 000 000 000 000 000 104 153 153 153 153 153 153 153 153 153
153 153 153 153 153 153 153 153 153 153 119 183 183 183 183 183 183 183 183 183 120 122 000 000 000 000 000 000 000 000 000 000 000 000 000 000 000 000 000 000 000 000 000 000 000 000 106 153 153 153 153 153 153 153 153 153
153 153 153 153 153 153 153 153 153 153 119 183 183 183 183 183 183 183 183 183 183 184 000 000 000 000 000 000 000 000 000 000 000 000 000 000 000 000 000 000 000 000 000 000 000 000 104 153 153 153 153 153 153 153 153 153
153 153 153 153 153 153 153 153 153 153 119 183 183 183 183 183 183 183 183 183 115 117 000 000 000 000 000 000 000 000 000 000 000 000 000 000 000 000 000 000 000 000 000 000 000 000 106 153 153 153 153 153 153 153 153 153
153 153 153 153 153 153 153 153 153 153 119 183 183 183 183 183 183 183 183 183 118 119 000 000 000 000 000 000 000 000 000 000 000 000 000 000 000 000 000 000 000 000 000 000 000 000 104 153 153 153 153 153 153 153 153 153
153 153 153 153 153 153 153 153 153 153 119 183 183 183 183 183 183 183 183 183 118 119 000 000 000 000 000 000 000 000 000 000 000 000 000 000 000 000 000 000 000 000 000 000 000 000 106 153 153 153 153 153 153 153 153 153
153 153 153 153 153 153 153 153 153 153 119 183 183 183 183 183 183 183 183 183 118 119 000 000 000 000 000 000 000 000 000 000 000 000 000 000 000 000 000 000 000 000 000 000 000 000 104 153 153 153 153 153 153 153 153 153
153 153 153 153 153 153 153 153 153 153 153 116 116 116 116 116 116 116 116 116 153 119 000 000 000 000 000 000 000 000 000 000 000 000 000 000 000 000 000 000 000 000 000 000 000 000 106 102 103 107 106 107 106 107 104 103
153 153 153 153 153 153 153 153 153 153 153 153 153 153 153 153 153 153 153 153 153 119 000 000 000 000 000 000 000 000 000 000 000 000 000 000 000 000 000 000 000 000 000 000 000 000 104 100 101 105 152 000 000 000 106 101
153 153 153 153 153 153 153 153 153 153 153 153 153 153 153 153 153 153 153 153 104 105 000 000 000 000 000 000 000 000 000 000 000 000 000 000 000 000 000 000 000 000 000 000 000 000 106 102 103 107 152 000 000 000 104 103
153 153 153 153 153 153 153 153 153 153 153 153 153 153 153 153 153 153 153 153 103 107 000 000 000 000 000 000 000 000 000 000 000 000 000 000 000 000 000 000 000 000 000 000 000 000 104 100 101 105 152 000 000 000 106 101
153 153 153 153 153 153 153 153 153 153 153 153 153 153 153 153 153 153 153 153 101 105 000 000 000 000 000 000 000 000 000 000 000 000 000 000 000 000 000 000 000 000 000 000 000 000 106 102 103 107 152 000 000 000 104 103
153 153 153 153 153 153 153 153 153 153 153 153 153 153 153 153 153 153 153 153 103 107 000 000 000 000 000 000 000 000 000 000 000 000 000 000 000 000 000 000 000 000 000 000 000 000 104 100 101 105 152 000 000 000 106 101
153 153 153 153 153 153 153 153 153 153 153 153 153 153 153 153 153 153 153 153 101 105 000 000 000 000 000 000 000 000 000 000 000 000 000 000 000 000 000 000 000 000 000 000 000 000 106 102 103 107 152 000 000 000 104 103
153 153 153 153 153 153 153 153 153 153 153 153 153 153 153 153 153 153 153 153 103 107 000 000 000 000 000 000 000 000 000 000 000 000 000 000 000 000 000 000 000 000 000 000 000 000 104 100 101 105 152 000 000 000 106 101
153 153 153 153 153 153 153 153 153 153 153 153 153 153 153 153 153 153 153 153 101 105 000 000 000 000 000 000 000 000 000 000 000 000 000 000 000 000 000 000 000 000 000 000 000 000 106 102 103 107 152 000 000 000 104 103
153 153 153 153 153 153 153 153 153 153 153 153 153 153 153 153 153 153 153 153 103 107 000 000 000 000 000 000 000 000 000 000 000 000 000 000 000 000 000 000 000 000 000 000 000 000 104 100 101 105 152 000 000 000 106 101
153 153 153 153 153 153 153 153 153 153 153 153 153 153 153 153 153 153 153 153 101 105 000 000 000 000 000 000 000 000 000 000 000 000 000 000 000 000 000 000 000 000 000 000 000 000 106 102 103 107 152 000 000 000 104 103
153 153 153 153 153 153 153 153 153 153 153 153 153 153 153 153 153 153 153 153 103 107 000 000 000 000 000 000 000 000 000 000 000 000 000 000 000 000 000 000 000 000 000 000 000 000 104 100 101 105 152 000 000 000 106 101
153 153 153 153 153 153 153 153 153 153 153 153 153 153 153 153 153 153 153 153 101 105 000 000 000 000 000 000 000 000 000 000 000 000 000 000 000 000 000 000 000 000 000 000 000 000 106 102 103 107 152 000 000 000 104 103
153 153 153 153 153 153 153 153 153 153 153 153 153 153 153 153 153 153 153 153 103 107 000 000 000 000 000 000 000 000 000 000 000 000 000 000 000 000 000 000 000 000 000 000 000 000 000 106 107 000 000 000 000 000 106 101
153 153 153 153 153 153 153 153 153 153 153 153 153 153 153 153 153 153 153 153 101 105 000 000 000 000 000 000 000 000 000 000 000 000 000 000 000 000 000 000 000 000 000 000 000 000 000 000 000 000 000 000 000 000 104 103
153 153 153 153 153 153 153 153 153 153 153 153 153 153 153 153 153 153 153 153 106 107 000 000 000 000 000 000 000 000 000 000 000 000 000 000 000 000 000 000 000 000 000 000 000 000 000 000 000 000 000 000 000 000 106 107
153 153 153 153 153 153 153 153 153 153 103 102 105 104 105 104 105 104 105 104 105 104 105 104 105 104 105 104 105 104 105 104 105 104 105 000 000 104 105 104 105 104 105 104 105 104 105 104 105 104 105 104 105 104 105 104
153 153 153 153 153 153 153 153 153 153 101 100 101 100 101 100 101 100 101 100 101 100 101 100 101 100 101 100 101 100 101 100 101 100 107 000 104 100 101 100 101 100 101 100 101 100 101 100 101 100 101 100 101 100 101 100
153 153 153 153 153 153 153 153 153 153 106 107 106 107 106 107 106 107 106 107 106 107 106 107 106 107 106 107 106 107 106 107 106 107 000 000 106 107 106 107 106 107 106 107 106 107 106 107 106 107 106 107 106 107 106 107
153 153 153 153 153 153 153 153 153 153 104 105 000 000 000 000 000 000 000 000 000 000 000 000 000 000 000 000 000 000 000 000 000 000 000 000 000 000 000 000 000 000 000 000 000 000 104 105 153 153 153 153 153 153 153 153
153 153 153 153 153 153 153 153 153 153 103 107 000 000 000 000 000 000 000 000 000 000 000 000 000 000 000 000 000 000 000 000 000 000 000 000 000 000 000 000 000 000 000 000 000 000 106 101 153 153 153 153 153 153 153 153
153 153 153 153 153 153 153 153 153 153 101 105 000 000 000 000 000 000 000 000 000 000 000 000 000 000 000 000 000 000 000 000 000 000 000 000 000 000 000 000 000 000 000 000 000 000 104 103 153 153 153 153 153 153 153 153
153 153 153 153 153 153 153 153 153 153 103 107 000 000 000 000 000 000 000 000 000 000 000 000 000 000 000 000 000 000 104 105 000 000 000 000 000 000 000 000 000 000 000 000 000 000 106 101 153 153 153 153 153 153 153 153
153 153 153 153 153 153 153 153 153 153 101 105 000 000 000 000 000 000 000 000 000 000 000 000 000 000 000 000 000 000 106 107 000 000 000 000 000 000 000 000 000 000 000 000 000 000 104 103 153 153 153 153 153 153 153 153
153 153 153 153 153 153 153 153 153 153 103 107 000 000 000 000 000 000 000 000 000 000 000 000 000 000 000 000 000 000 000 000 000 000 000 000 000 000 000 000 000 000 000 000 000 000 106 101 153 153 153 153 153 153 153 153
153 153 153 153 153 153 153 153 153 153 101 105 000 000 000 000 000 000 000 000 000 000 000 000 000 000 000 000 000 000 000 000 000 000 000 000 000 000 000 104 105 000 000 000 000 000 104 103 153 153 153 153 153 153 153 153
153 153 153 153 153 153 153 153 153 153 103 107 000 000 000 000 000 000 000 000 000 000 000 000 000 000 000 000 000 000 000 000 000 000 000 000 000 000 000 106 107 000 000 000 000 000 106 101 153 153 153 153 153 153 153 153
153 153 153 153 153 153 153 153 153 153 101 105 000 000 000 000 000 000 000 000 000 000 000 000 000 000 000 000 000 000 000 000 000 000 000 000 000 000 000 000 000 000 000 000 000 000 104 103 153 153 153 153 153 153 153 153
153 153 153 153 153 153 153 153 153 153 106 107 000 000 000 000 000 000 000 000 000 000 000 000 000 000 000 000 000 000 000 000 000 000 000 000 000 000 000 000 000 000 000 000 000 000 106 101 153 153 153 153 153 153 153 153
153 153 153 153 153 153 153 153 153 153 115 116 116 116 116 116 116 116 117 000 000 000 000 000 000 000 000 000 000 000 000 000 000 000 000 000 000 000 000 000 000 000 000 000 000 000 104 103 153 153 153 153 153 153 153 153
153 153 153 153 153 153 153 153 153 153 118 153 121 121 121 121 121 153 119 000 000 000 012 000 000 000 000 000 000 000 000 000 104 105 000 000 000 000 000 000 000 000 000 000 000 000 106 101 153 153 153 153 153 153 153 153
153 153 153 153 153 153 153 153 153 153 118 119 183 183 183 183 183 118 119 000 000 000 002 000 000 000 000 000 000 000 000 000 106 107 000 000 000 000 000 000 000 000 000 000 000 000 104 103 153 153 153 153 153 153 153 153
153 153 153 153 153 153 153 153 153 153 118 119 183 183 183 183 183 118 119 000 000 000 002 000 000 000 000 000 000 000 000 000 000 000 000 000 000 000 000 000 000 000 000 000 000 000 106 101 153 153 153 153 153 153 153 153
153 153 153 153 153 153 153 153 153 153 118 119 183 183 184 183 183 118 119 000 000 000 002 002 002 002 002 000 000 000 000 000 000 000 000 000 000 000 000 000 000 000 000 000 000 000 104 103 153 153 153 153 153 153 153 153
153 153 153 153 153 153 153 153 153 153 118 119 183 183 183 183 183 118 119 000 000 000 000 000 000 000 002 000 000 000 000 000 000 000 000 000 000 000 000 000 000 000 000 000 000 000 106 101 153 153 153 153 153 153 153 153
153 153 153 153 153 153 153 153 153 153 118 119 183 183 183 183 183 118 119 000 000 000 000 000 002 002 002 000 000 000 000 000 000 000 000 000 000 000 000 000 000 000 000 000 000 000 104 103 153 153 153 153 153 153 153 153
153 153 153 153 153 153 153 153 153 153 118 119 183 183 183 183 183 118 119 000 000 000 000 000 002 152 152 117 000 000 000 000 000 012 000 000 000 000 000 000 000 000 000 000 000 000 106 101 153 153 153 153 153 153 153 153
153 153 153 153 153 153 153 153 153 153 118 119 183 183 183 183 183 118 119 000 000 000 000 000 017 000 118 152 152 152 152 152 152 153 152 152 152 152 152 152 152 152 152 152 152 153 104 103 153 153 153 153 153 153 153 153
105 104 105 104 105 104 105 104 105 104 118 153 116 116 116 117 185 118 119 000 000 000 000 000 000 000 118 119 152 152 152 152 152 153 152 152 152 152 152 152 152 152 152 152 152 153 106 101 153 153 153 153 153 153 153 153
101 100 101 100 101 100 101 100 101 100 118 153 121 121 121 122 185 120 153 116 116 116 117 183 115 116 153 119 152 152 152 152 152 153 153 153 153 153 152 152 152 152 152 152 152 153 104 103 153 153 153 153 153 153 153 153
103 107 106 107 106 107 106 107 106 107 120 122 183 183 183 184 183 183 118 153 121 121 122 183 120 121 153 119 152 152 152 152 152 152 152 152 152 153 152 152 152 152 152 152 152 153 106 101 153 153 153 153 153 153 153 153
101 105 000 000 000 000 000 000 000 000 184 183 183 183 183 183 183 183 118 119 183 183 183 184 183 183 118 119 152 152 152 152 152 152 152 153 153 153 152 152 152 152 152 152 153 153 104 103 153 153 153 153 153 153 153 153
103 107 000 000 000 000 000 000 000 000 184 183 184 183 183 183 183 183 120 122 183 183 183 183 183 183 118 119 152 152 152 152 152 152 152 153 152 152 152 152 152 152 152 152 153 152 106 101 153 153 153 153 153 153 153 153
101 105 000 000 000 000 000 000 104 105 115 117 183 183 183 183 183 183 183 183 183 183 183 183 183 183 120 122 000 000 000 000 000 000 000 017 000 000 000 000 000 000 000 000 000 000 104 103 153 153 153 153 153 153 153 153
103 107 000 000 000 000 000 000 106 107 118 119 183 183 183 183 183 183 115 117 183 183 183 183 183 183 183 184 000 000 000 000 000 000 000 000 000 000 000 000 000 000 000 000 000 000 106 101 153 153 153 153 153 153 153 153
101 105 000 000 000 000 000 000 104 105 118 119 183 183 183 183 183 183 118 119 183 183 183 183 183 183 115 117 000 000 000 000 000 000 000 000 000 000 000 000 000 000 000 000 000 000 104 103 153 153 153 153 153 153 153 153
103 107 000 000 000 000 000 000 106 107 118 119 183 183 184 183 183 183 118 119 183 183 183 183 183 183 118 119 000 000 000 000 000 000 000 000 000 000 000 000 000 000 000 000 000 000 106 101 153 153 153 153 153 153 153 153
101 105 000 000 000 000 000 000 104 105 118 119 183 183 183 183 183 183 118 119 183 183 183 183 183 183 118 119 000 000 000 000 000 000 000 000 000 000 000 000 000 000 000 000 000 000 104 103 153 153 153 153 153 153 153 153
103 107 000 000 000 000 000 000 106 107 118 119 183 183 183 183 184 183 118 119 183 183 183 183 183 183 118 119 000 000 000 000 000 000 000 000 000 000 000 000 000 000 000 000 000 000 106 101 153 153 153 153 153 153 153 153
101 105 000 000 000 000 000 000 104 105 118 119 183 183 183 183 183 183 118 119 183 183 183 183 183 183 118 119 000 000 000 000 000 000 000 000 000 000 000 000 000 000 000 000 000 000 104 103 153 153 153 153 153 153 153 153
103 102 105 000 000 000 000 104 103 107 118 119 183 183 183 183 183 183 118 119 183 183 183 183 183 183 118 119 000 000 000 000 000 000 000 000 000 000 000 000 000 000 000 000 000 000 106 101 153 153 153 153 153 153 153 153
101 100 101 105 000 000 104 100 101 105 153 153 116 116 116 116 116 116 153 153 116 116 117 183 115 116 153 119 000 000 000 000 000 000 000 000 012 000 000 000 000 000 000 000 000 000 104 103 153 153 153 153 153 153 153 153
103 102 103 107 000 000 106 102 103 107 153 153 153 153 153 153 153 153 153 153 121 121 122 183 120 121 153 119 000 000 000 000 000 000 000 000 002 000 000 000 000 000 000 000 000 000 106 101 153 153 153 153 153 153 153 153
101 100 107 000 000 000 000 106 101 105 153 153 153 153 153 153 153 153 153 119 183 183 183 184 183 183 118 119 000 000 000 000 000 000 000 000 002 000 000 000 000 000 000 000 000 000 104 103 153 153 153 153 153 153 153 153
103 107 000 000 000 000 000 000 106 107 153 153 153 153 153 153 153 153 153 119 183 183 183 183 183 183 118 119 000 000 000 000 000 000 000 000 002 002 002 002 002 000 000 000 000 000 106 101 153 153 153 153 153 153 153 153
101 105 000 000 000 000 000 000 104 105 153 153 153 153 153 153 153 153 153 119 183 183 183 183 183 183 118 119 000 000 000 000 000 000 000 000 000 000 000 000 002 000 000 000 000 000 104 103 153 153 153 153 153 153 153 153
103 107 000 000 000 000 000 000 106 107 153 153 153 153 153 153 153 153 153 119 183 183 183 183 183 183 118 119 000 000 000 000 000 000 000 000 000 000 002 002 002 000 000 000 000 000 106 101 153 153 153 153 153 153 153 153
101 105 000 000 000 000 000 000 104 105 153 153 153 153 153 153 153 153 153 119 183 183 183 183 183 183 118 119 000 000 000 000 000 000 000 000 000 000 002 000 000 000 000 000 000 000 104 103 153 153 153 153 153 153 153 153
103 107 000 000 000 000 000 000 106 107 153 153 153 153 153 153 153 153 153 153 116 116 116 116 116 116 153 119 000 000 000 000 000 000 000 000 000 000 017 000 000 000 000 000 000 000 106 107 153 153 153 153 153 153 153 153
101 105 104 105 000 000 104 105 104 105 153 153 153 153 153 153 153 153 153 153 153 153 153 153 153 153 153 119 000 104 105 104 105 104 105 104 105 104 105 104 105 104 105 104 105 104 105 104 153 153 153 153 153 153 153 153