74 14
64 64
153 153 153 153 153 153 153 153 153 153 153 153 153 153 153 153 153 153 153 153 153 153 153 153 153 153 153 153 153 153 153 153 153 153 153 153 153 153 153 153 153 153 153 153 153 153 153 153 153 153 153 153 153 153 153 153 153 153 153 153 153 153 153 153 153 153 153 153 153 153 153 153 153 153
153 153 153 153 153 153 153 153 153 153 153 153 153 153 153 153 153 153 153 153 153 153 153 153 153 153 153 153 153 153 153 153 153 153 153 153 153 128 124 124 124 124 124 124 124 124 124 124 124 124 124 124 129 153 153 153 153 153 101 100 101 100 101 100 101 100 101 100 101 100 101 100 101 100
153 153 087 158 159 159 159 159 159 159 159 160 086 153 153 153 153 153 153 087 158 159 159 159 159 159 159 159 160 086 153 153 153 153 153 153 153 126 123 123 123 123 123 123 123 123 123 123 123 123 123 123 127 153 153 153 153 153 103 107 106 107 106 107 106 107 106 107 106 107 106 107 106 102
153 153 087 161 162 162 162 162 162 162 162 163 086 153 153 153 153 153 153 087 161 162 162 162 162 162 162 162 163 086 153 153 153 153 153 153 153 126 123 123 123 123 123 123 123 123 123 123 123 123 123 123 127 153 153 153 153 153 101 105 000 000 000 000 000 000 000 000 000 000 000 000 104 100
153 153 087 164 164 164 164 164 164 164 164 164 086 153 153 153 153 153 153 087 164 164 164 164 164 164 164 164 164 086 153 153 153 153 153 153 153 126 123 123 123 123 123 123 123 123 123 123 123 123 123 123 127 153 153 153 153 153 103 107 000 000 000 000 000 000 000 000 000 000 000 000 106 102
153 153 087 164 164 164 164 164 164 164 164 164 086 153 153 153 153 153 153 087 164 164 164 164 164 164 164 164 164 086 153 153 153 153 153 153 153 126 123 123 123 123 123 123 123 123 123 123 123 123 123 123 127 153 153 153 153 153 101 105 000 000 000 000 000 000 000 000 000 000 000 000 104 100
153 153 087 164 164 164 164 164 164 164 164 164 086 153 153 153 153 153 153 087 164 164 164 164 164 164 164 164 164 086 153 153 153 153 153 153 153 126 123 123 123 123 123 123 123 123 123 123 123 123 123 123 127 153 153 153 153 153 103 107 000 000 000 000 000 000 000 000 000 000 000 000 106 102
153 153 087 164 164 164 164 164 164 164 164 164 086 153 153 153 153 153 153 087 164 164 164 164 164 164 164 164 164 086 153 153 153 153 153 153 153 126 123 123 123 123 123 123 123 123 123 123 123 123 123 123 127 153 153 153 153 153 101 105 000 000 000 000 000 000 000 000 000 000 000 000 104 100
153 153 087 164 164 164 164 164 164 164 164 164 086 153 153 153 153 153 153 087 164 164 164 164 164 164 164 164 164 086 153 153 153 153 153 153 153 126 123 123 123 123 123 123 123 123 123 123 123 123 123 123 127 153 153 153 153 153 103 107 000 000 000 000 000 000 000 000 000 000 000 000 106 102
153 153 087 164 164 164 164 164 164 164 164 164 086 153 153 153 153 153 153 087 164 164 164 164 164 164 164 164 164 086 153 153 153 153 153 153 153 126 123 123 123 123 123 123 123 123 123 123 123 123 123 123 127 153 153 153 153 153 101 105 000 000 000 000 000 000 000 000 000 000 000 000 104 100
153 153 087 164 164 164 164 164 164 164 164 164 086 153 153 153 153 153 153 087 164 164 164 164 164 164 164 164 164 086 153 153 153 153 153 153 153 126 123 123 123 123 123 123 123 123 123 123 123 123 123 123 127 153 153 153 153 153 103 107 000 000 000 000 000 000 000 000 000 000 000 000 106 102
153 153 153 084 084 084 084 084 084 084 084 084 153 153 153 153 153 153 153 153 084 084 084 084 084 084 084 084 084 153 153 153 153 153 153 153 153 126 123 123 123 123 123 123 123 123 123 123 123 123 123 123 127 153 153 153 153 153 101 105 104 105 104 105 104 105 104 105 104 105 104 105 104 100
153 153 153 153 153 153 153 153 153 153 153 153 153 153 153 153 153 153 153 153 153 153 153 153 153 153 153 153 153 153 153 153 153 153 153 153 153 130 125 125 125 125 125 125 125 125 125 125 125 125 125 125 131 153 153 153 153 153 103 102 103 102 103 102 103 102 103 102 103 102 103 102 103 102
153 153 153 153 153 153 153 153 153 153 153 153 153 153 153 153 153 153 153 153 153 153 153 153 153 153 153 153 153 153 153 153 153 153 153 153 153 153 153 153 153 153 153 153 153 153 153 153 153 153 153 153 153 153 153 153 153 153 153 153 153 153 153 153 153 153 153 153 153 153 153 153 153 153