40 70
1344 3648
153 153 153 153 153 153 153 153 153 153 153 153 153 153 189 089 089 089 089 089 089 089 089 089 089 089 089 188 153 153 153 153 153 153 153 153 153 153 153 153
189 089 089 089 089 089 089 188 189 089 089 089 089 188 087 075 075 075 075 075 075 075 075 075 075 075 075 086 189 089 089 089 089 188 189 089 089 089 089 188
087 075 075 075 075 075 075 086 087 075 075 075 075 086 087 075 075 075 075 075 075 075 075 075 075 075 075 086 087 075 075 075 075 086 087 075 075 075 075 086
087 075 075 075 075 075 075 086 087 075 075 075 075 086 087 075 075 075 075 075 075 075 075 075 075 075 075 086 087 075 075 075 075 086 087 075 075 075 075 086
087 075 075 075 075 075 075 086 087 075 075 075 075 086 087 075 075 075 075 075 075 075 075 075 075 075 075 086 087 075 075 075 075 086 087 075 075 075 075 086
087 075 075 075 075 075 075 086 087 075 075 075 075 086 087 075 075 075 075 075 075 075 075 075 075 075 075 086 087 075 075 075 075 086 087 075 075 075 075 086
087 075 075 075 075 075 075 086 187 084 085 075 083 186 087 075 075 075 075 075 075 075 075 075 075 075 075 086 187 085 075 083 084 186 087 075 075 075 075 086
087 075 075 075 075 075 075 086 189 089 090 050 088 188 087 075 075 075 075 075 075 075 075 075 075 075 075 086 189 090 050 088 089 188 087 075 075 075 075 086
087 075 075 075 075 075 075 086 087 075 075 075 075 086 087 075 075 075 075 075 075 075 075 075 075 075 075 086 087 075 075 075 075 086 087 075 075 075 075 086
087 075 075 075 075 075 075 088 090 075 075 075 075 086 087 075 075 075 075 075 075 075 075 075 075 075 075 086 087 075 075 075 075 088 090 075 075 075 075 086
087 075 075 075 075 075 075 075 075 075 075 075 075 088 090 075 075 075 075 075 075 075 075 075 075 075 075 088 090 075 075 075 075 075 075 075 075 075 075 086
087 075 075 075 075 075 075 065 066 066 066 066 066 050 066 066 066 066 066 066 066 066 066 066 066 066 066 066 050 066 066 066 066 066 067 075 075 075 075 086
087 075 075 075 075 075 075 068 073 073 073 073 073 083 085 073 073 073 073 073 073 073 073 073 073 073 073 083 085 073 073 073 073 073 069 075 075 075 075 086
087 075 075 075 075 075 075 068 073 073 071 071 071 086 087 071 071 071 071 071 071 071 071 071 071 071 071 086 087 071 071 071 073 073 069 075 075 075 075 086
087 075 075 075 075 075 075 068 073 069 075 075 075 086 087 075 075 075 075 075 075 075 075 075 075 075 075 086 087 075 075 075 068 073 069 075 083 084 084 186
187 084 084 084 084 085 075 068 073 069 075 083 084 186 187 084 084 084 085 075 075 075 075 083 084 084 084 153 187 084 085 075 068 073 069 075 086 153 153 153
153 153 153 153 153 087 075 068 073 069 075 086 153 153 153 153 153 153 087 075 075 075 075 086 153 153 153 153 153 153 087 075 068 073 069 075 086 153 153 153
153 153 153 153 153 087 075 068 073 069 075 086 153 153 153 153 153 153 187 084 084 084 084 186 153 153 153 153 153 153 087 075 068 073 069 075 086 153 153 153
153 153 153 153 153 087 075 068 073 069 075 086 153 153 153 153 153 153 153 153 089 153 153 153 153 153 153 153 153 153 087 075 068 073 069 075 086 153 153 153
153 153 189 089 089 090 075 068 073 069 075 088 089 089 188 189 089 089 089 090 123 088 089 089 089 089 188 189 089 089 090 075 068 073 069 075 088 089 089 188
153 153 087 075 075 075 075 068 073 069 075 075 075 075 086 087 075 075 075 068 073 073 069 075 075 075 086 087 075 075 075 075 068 073 069 075 075 075 075 086
153 153 087 075 075 075 075 068 073 069 075 075 075 075 086 087 075 075 075 068 073 073 069 075 075 075 086 087 075 075 075 075 068 073 069 075 075 075 075 086
153 153 087 075 075 075 075 068 073 069 075 075 075 075 086 087 075 075 075 068 073 073 069 075 075 075 086 087 075 075 075 075 068 073 069 075 075 075 075 086
153 153 087 075 075 075 075 068 073 069 075 075 075 075 086 087 075 075 075 068 073 073 069 075 075 075 086 087 075 075 075 075 068 073 069 075 075 075 075 086
153 153 087 075 075 075 075 068 073 069 075 075 075 075 086 087 075 075 075 068 073 073 069 075 075 075 086 087 075 075 075 075 068 073 069 075 075 075 075 086
153 153 087 075 075 075 075 068 073 069 075 075 075 075 086 087 075 075 075 068 073 073 069 075 075 075 086 087 075 075 075 075 068 073 069 075 075 075 075 086
153 153 087 075 075 075 075 068 073 069 075 075 075 075 086 087 075 075 075 068 073 073 069 075 075 075 086 087 075 075 075 075 068 073 069 075 075 075 075 086
153 153 087 075 075 075 075 068 073 069 075 075 075 075 086 087 075 075 075 068 073 073 069 075 075 075 086 087 075 075 075 075 068 073 069 075 075 075 075 086
153 153 087 075 075 075 075 068 073 069 075 075 075 075 086 087 075 075 075 068 073 073 069 075 075 075 086 087 075 075 075 075 068 073 069 075 075 075 075 086
153 153 087 075 075 075 075 068 073 069 075 075 075 075 086 087 075 075 075 068 073 073 069 075 075 075 086 087 075 075 075 075 068 073 069 075 075 075 075 086
153 153 087 075 075 075 075 068 073 069 075 075 075 075 086 087 075 075 075 068 073 073 069 075 075 075 086 087 075 075 075 075 068 073 069 075 075 075 075 086
153 153 087 075 075 075 075 068 073 069 075 075 075 075 086 087 075 075 075 068 073 073 069 075 075 075 086 087 075 075 075 075 068 073 069 075 075 075 075 086
153 153 087 075 075 075 075 068 073 069 075 075 075 075 086 087 075 075 075 068 073 073 069 075 075 075 086 087 075 075 075 075 068 073 069 075 075 075 075 086
153 153 087 075 075 075 075 068 073 069 075 075 075 075 086 087 075 075 075 068 073 073 069 075 075 075 086 087 075 075 075 075 068 073 069 075 075 075 075 086
153 153 087 075 075 075 075 068 073 069 075 075 075 075 086 087 075 075 075 068 073 073 069 075 075 075 086 087 075 075 075 075 068 073 069 075 075 075 075 086
153 153 087 075 075 075 075 068 073 069 075 075 075 075 086 087 075 075 075 068 073 073 069 075 075 075 086 087 075 075 075 075 068 073 069 075 075 075 075 086
153 153 087 075 075 075 075 068 073 069 075 075 075 075 086 087 075 075 075 068 073 073 069 075 075 075 086 087 075 075 075 075 068 073 069 075 075 075 075 086
153 153 087 075 075 075 075 068 073 069 075 075 075 075 086 087 075 075 075 068 073 073 069 075 075 075 086 087 075 075 075 075 068 073 069 075 075 075 075 086
153 153 187 084 084 085 075 068 073 069 075 083 084 084 186 087 075 075 075 068 073 073 069 075 075 075 086 187 084 084 085 075 068 073 069 075 083 084 084 186
153 153 153 153 153 087 075 068 073 069 075 086 153 153 153 087 075 075 075 068 073 073 069 075 075 075 086 153 153 153 087 075 068 073 069 075 086 153 153 153
153 153 153 153 153 087 075 068 073 069 075 086 153 153 153 187 084 084 084 085 073 073 083 084 084 084 186 153 153 153 087 075 068 073 069 075 086 153 153 153
153 153 153 153 153 087 075 068 073 069 075 086 189 089 089 089 089 089 089 090 073 073 088 089 089 089 089 089 089 188 087 075 068 073 069 075 086 153 153 153
153 153 153 153 153 087 075 068 073 069 075 086 087 075 075 075 075 075 075 068 073 073 069 075 075 075 075 075 075 086 087 075 068 073 069 075 086 153 153 153
153 153 153 153 153 087 075 068 073 069 075 086 087 075 075 075 075 075 075 068 073 073 069 075 075 075 075 075 075 086 087 075 068 073 069 075 086 153 153 153
153 153 153 153 153 087 075 068 073 069 075 086 087 075 075 075 075 075 075 068 073 073 069 075 075 075 075 075 075 086 087 075 068 073 069 075 086 153 153 153
153 153 153 153 153 087 075 068 073 069 075 086 087 075 075 075 075 075 075 068 073 073 069 075 075 075 075 075 075 086 087 075 068 073 069 075 086 153 153 153
153 153 153 153 153 087 075 068 073 069 075 086 087 075 075 075 075 075 075 068 073 073 069 075 075 075 075 075 075 086 087 075 068 073 069 075 086 153 153 153
153 153 153 153 153 087 075 068 073 069 075 086 087 078 078 078 078 078 078 154 155 155 156 078 078 078 078 078 078 086 087 075 068 073 069 075 086 153 153 153
153 153 153 153 153 087 075 068 073 073 066 088 090 066 066 066 067 075 152 154 155 155 156 152 075 065 066 066 066 088 090 066 073 073 069 075 086 153 153 153
153 153 153 153 153 087 075 068 073 073 073 073 050 073 073 073 069 075 152 154 155 155 156 152 075 068 073 073 073 050 073 073 073 073 069 075 086 153 153 153
153 153 153 153 153 087 075 068 073 073 071 083 085 071 073 073 069 075 152 154 155 155 156 152 075 068 073 073 071 083 085 071 073 073 069 075 086 153 153 153
153 153 153 153 153 087 075 068 073 069 075 086 087 075 068 073 069 075 075 068 073 073 069 075 075 068 073 069 075 086 087 075 068 073 069 075 086 153 153 153
153 153 153 153 153 087 075 068 073 069 075 086 087 075 068 073 073 066 066 074 073 073 073 066 066 074 073 069 075 086 087 075 068 073 069 075 086 153 153 153
153 153 153 153 153 087 075 068 073 069 075 086 087 075 068 073 073 073 073 073 073 073 073 073 073 073 073 069 075 086 087 075 068 073 069 075 086 153 153 153
153 153 153 153 153 087 075 068 073 069 075 086 087 075 070 071 071 071 071 071 073 073 071 071 071 071 071 072 075 086 087 075 068 073 069 075 086 153 153 153
153 153 153 153 153 087 075 068 073 069 075 086 087 075 075 075 075 075 075 075 068 069 075 075 075 075 075 075 075 086 087 075 068 073 069 075 086 153 153 153
153 153 153 153 153 087 075 068 073 069 075 086 087 075 075 075 075 075 075 075 068 069 075 075 075 075 075 075 075 086 087 075 068 073 069 075 086 153 153 153
153 153 153 153 153 087 075 068 073 069 075 086 087 075 075 075 075 075 075 075 068 069 075 075 075 075 075 075 075 086 087 075 068 073 069 075 086 153 153 153
153 153 153 153 153 087 075 068 073 069 075 086 187 084 084 084 084 084 084 085 154 156 083 084 084 084 084 084 084 186 087 075 068 073 069 075 086 153 153 153
189 089 089 089 089 090 075 068 073 069 075 088 188 153 153 153 153 153 153 153 153 153 153 153 153 189 089 089 089 089 090 075 068 073 069 075 088 188 153 153
087 075 075 075 075 075 075 075 075 075 075 075 086 153 153 153 153 153 153 153 153 153 153 153 153 087 075 075 075 075 075 075 075 075 075 075 075 086 153 153
087 075 075 075 075 075 075 075 075 075 075 075 086 153 153 153 153 153 153 153 153 153 153 153 153 087 075 075 075 075 075 075 075 075 075 075 075 086 153 153
087 075 075 075 075 075 075 075 075 075 075 075 086 153 153 153 153 153 153 153 153 153 153 153 153 087 075 075 075 075 075 075 075 075 075 075 075 086 153 153
087 075 075 075 075 075 075 075 075 075 075 075 086 153 153 153 153 153 153 153 153 153 153 153 153 087 075 075 075 075 075 075 075 075 075 075 075 086 153 153
087 075 075 075 075 075 075 075 075 075 075 075 086 153 153 153 153 153 153 153 153 153 153 153 153 087 075 075 075 075 075 075 075 075 075 075 075 086 153 153
087 075 075 075 075 075 075 075 075 075 075 075 086 153 153 153 153 153 153 153 153 153 153 153 153 087 075 075 075 075 075 075 075 075 075 075 075 086 153 153
087 075 075 075 075 075 075 075 075 075 075 075 086 153 153 153 153 153 153 153 153 153 153 153 153 087 075 075 075 075 075 075 075 075 075 075 075 086 153 153
087 075 075 075 075 075 075 075 075 075 075 075 086 153 153 153 153 153 153 153 153 153 153 153 153 087 075 075 075 075 075 075 075 075 075 075 075 086 153 153
087 075 075 075 075 075 075 075 075 075 075 075 086 153 153 153 153 153 153 153 153 153 153 153 153 087 075 075 075 075 075 075 075 075 075 075 075 086 153 153
187 084 084 084 084 084 084 084 084 084 084 084 186 153 153 153 153 153 153 153 153 153 153 153 153 187 084 084 084 084 084 084 084 084 084 084 084 186 153 153