60 60
256 256
101 100 101 100 101 100 101 100 101 100 101 100 101 100 101 100 101 100 101 100 101 100 101 100 101 100 101 100 101 100 101 100 101 100 101 100 101 100 101 100 101 100 101 100 101 100 101 100 101 100 101 128 124 124 124 129 101 100 101 100
103 107 106 107 106 107 106 107 106 107 106 107 106 107 106 107 106 107 106 107 106 107 106 107 106 107 106 107 106 107 106 107 106 107 106 107 106 107 106 107 106 107 106 107 106 107 106 107 106 107 106 126 123 123 123 126 106 107 106 102
101 105 000 000 000 000 000 000 000 000 000 000 000 000 000 000 000 000 000 000 000 000 000 000 000 000 000 000 000 000 000 000 000 000 000 000 000 000 000 000 000 000 000 000 000 000 000 000 000 000 000 000 123 123 123 000 000 000 104 100
103 107 000 000 000 000 000 000 000 000 000 000 000 000 000 000 000 000 000 000 000 000 000 000 000 000 000 000 000 000 000 000 000 000 000 000 000 000 000 000 000 000 000 000 000 000 000 000 000 000 000 000 006 123 007 000 000 000 106 102
101 105 000 000 000 000 000 000 000 000 000 000 000 000 000 000 000 000 000 000 000 000 000 000 000 000 000 000 000 000 000 000 000 000 000 000 000 000 000 000 000 000 000 000 000 000 000 000 000 000 000 000 006 001 007 000 000 000 104 100
103 107 000 000 003 004 004 004 005 000 000 000 000 000 000 000 000 000 000 000 000 000 000 000 000 000 000 000 000 000 000 000 000 012 012 000 000 000 000 000 000 000 000 000 000 000 000 000 000 000 000 000 006 001 007 000 000 000 106 102
101 105 000 000 006 001 001 001 007 000 000 000 000 000 000 000 000 000 000 000 000 000 000 000 000 000 000 000 000 011 012 012 012 002 002 012 012 012 013 000 000 000 000 000 000 000 000 000 000 000 000 000 006 001 007 000 000 000 104 100
103 107 000 000 006 001 001 001 007 000 000 000 000 000 000 000 000 000 000 000 000 000 000 000 000 000 000 000 000 014 002 002 002 002 002 002 002 002 015 000 000 000 000 000 000 000 000 000 000 000 000 000 006 001 007 000 000 000 106 102
101 105 000 000 006 001 001 001 007 000 000 000 000 000 000 000 000 000 000 000 000 000 000 000 000 000 000 000 000 014 002 002 002 002 002 002 002 002 015 000 000 000 000 000 000 000 000 000 000 000 000 000 006 001 007 000 000 000 104 100
103 107 000 000 008 001 001 001 010 000 000 000 000 000 000 000 000 000 000 000 000 000 000 000 000 000 000 000 000 014 002 002 002 002 002 002 002 002 015 000 000 000 000 000 000 000 000 000 000 000 000 000 006 001 007 000 000 000 106 102
101 105 000 000 000 006 001 007 000 000 000 000 000 000 000 000 000 000 000 000 000 000 000 000 000 000 000 000 000 014 002 002 002 002 002 002 002 002 015 000 000 000 000 000 000 000 000 000 000 000 000 000 006 001 007 000 000 000 104 100
103 107 000 000 000 006 001 007 000 000 000 000 000 000 000 000 000 000 000 000 000 000 000 000 000 000 000 000 000 016 017 017 017 017 017 017 017 017 018 000 000 000 000 000 000 000 000 000 000 000 000 000 006 001 007 000 000 000 106 102
101 105 000 000 000 006 001 001 004 004 004 004 004 004 004 004 004 004 004 004 004 004 004 004 004 004 004 004 004 004 004 004 004 004 004 004 004 004 004 004 004 004 004 004 004 004 004 004 004 004 004 004 001 001 007 000 000 000 104 100
103 107 000 000 000 008 009 009 009 009 009 009 009 009 009 009 009 009 009 009 009 009 009 009 009 009 009 009 009 009 009 009 001 001 001 001 009 009 009 009 009 009 009 009 009 009 009 009 009 009 009 009 009 009 010 000 000 000 106 102
101 105 000 000 000 000 000 000 000 000 000 000 000 000 000 000 000 000 000 000 000 000 000 000 000 000 000 000 000 000 000 000 006 001 001 007 000 000 000 000 000 000 000 000 000 000 000 000 000 000 000 000 000 000 000 000 000 000 104 100
103 107 000 000 000 000 000 000 000 000 000 000 000 000 000 000 000 000 000 000 000 000 000 000 000 000 000 000 000 000 000 000 006 001 001 007 000 000 000 000 000 000 000 000 000 000 000 000 000 000 000 000 000 000 000 000 000 000 106 102
101 105 000 000 000 000 000 000 000 000 000 000 000 000 000 000 000 000 000 000 000 000 000 000 000 000 000 000 000 000 000 000 006 001 001 007 000 000 000 000 000 000 000 000 000 000 000 000 000 000 000 000 000 000 000 000 000 000 104 100
103 107 000 000 000 000 000 000 000 000 000 000 000 000 000 000 000 000 000 000 000 000 000 000 000 000 000 000 000 000 000 000 006 001 001 007 000 000 000 000 000 000 000 000 000 000 000 000 000 000 000 000 000 000 000 000 000 000 106 102
101 105 000 000 000 000 000 000 000 000 000 000 000 000 000 000 000 000 000 000 000 000 000 000 000 000 000 000 000 000 000 000 006 001 001 007 000 000 000 000 000 000 000 000 000 000 000 000 000 000 000 000 000 000 000 000 000 000 104 100
103 107 000 000 000 000 000 000 000 000 000 000 000 000 000 000 000 000 000 000 000 000 000 000 000 000 000 000 000 000 000 000 006 001 001 007 000 000 000 000 000 000 000 000 000 000 000 000 000 000 000 000 000 000 000 000 000 000 106 102
101 105 000 000 000 000 000 000 000 000 000 000 000 000 000 000 000 000 000 000 000 000 000 000 000 000 000 000 000 000 000 000 006 001 001 007 000 000 000 000 000 000 000 000 000 000 000 000 000 000 000 000 000 000 000 000 000 000 104 100
103 107 000 000 000 000 000 000 000 000 000 000 000 000 000 000 000 000 000 000 000 000 000 000 000 000 000 000 000 000 000 000 006 001 001 007 000 000 000 000 000 000 000 000 000 000 000 000 000 000 000 000 000 000 000 000 000 000 106 102
101 105 000 000 000 000 000 000 000 000 000 000 000 000 000 000 000 000 000 000 000 000 000 000 000 000 000 000 000 000 000 000 006 001 001 007 000 000 000 000 000 000 000 000 000 000 000 000 000 000 000 000 000 000 000 000 000 000 104 100
103 107 000 000 000 000 000 000 000 000 000 000 000 000 000 000 000 000 000 000 000 000 000 000 000 000 000 000 000 000 000 000 006 001 001 007 000 000 000 000 000 000 000 000 000 000 000 000 000 000 000 000 000 000 000 000 000 000 106 102
101 105 000 000 000 000 000 000 000 000 000 000 000 000 000 000 000 000 000 000 000 000 000 000 000 000 000 000 000 000 000 000 006 001 001 007 000 000 000 000 000 000 000 000 000 000 000 000 000 000 000 000 000 000 000 000 000 000 104 100
103 107 000 000 000 000 000 000 000 000 000 000 000 000 000 000 000 000 000 000 000 000 000 000 000 000 000 000 000 000 000 000 006 001 001 007 000 000 000 000 000 000 000 000 000 000 000 000 000 000 000 000 000 000 000 000 000 000 106 102
101 105 000 000 000 000 000 000 000 000 000 000 000 000 000 000 000 000 000 000 000 000 000 000 000 000 000 000 000 000 000 000 006 001 001 007 000 000 000 000 000 000 000 000 000 000 000 000 000 000 000 000 000 000 000 000 000 000 104 100
103 107 000 000 000 000 000 000 000 000 000 000 000 000 000 000 000 000 000 000 000 000 000 000 000 000 000 000 000 000 000 000 006 001 001 007 000 000 000 000 000 000 000 000 000 000 000 000 000 000 000 000 000 000 000 000 000 000 106 102
101 105 000 000 000 000 000 000 000 000 000 000 000 000 000 000 000 000 000 000 000 000 000 000 000 000 000 000 000 000 000 000 006 001 001 007 000 000 000 000 000 000 000 000 000 000 000 000 000 000 000 000 000 050 050 050 050 050 104 100
103 107 000 000 114 114 114 114 114 000 000 000 000 000 000 000 000 000 000 000 000 000 000 000 000 000 000 000 000 000 000 000 006 001 001 007 000 000 000 000 000 000 000 000 000 000 000 000 000 000 000 000 000 050 050 050 050 050 106 102
101 105 000 000 114 114 114 114 114 000 000 000 000 000 000 000 000 000 000 000 000 000 000 000 000 000 000 000 000 000 000 000 006 001 001 007 000 000 000 000 000 000 000 000 000 000 000 000 000 000 000 000 000 000 050 050 007 000 104 100
103 107 000 000 114 114 114 114 114 000 000 000 000 000 000 000 000 000 000 000 000 000 000 000 000 000 000 000 000 000 000 000 006 001 001 007 000 000 000 000 000 000 000 000 000 000 000 000 000 000 000 000 000 000 050 001 050 000 106 102
101 105 000 000 000 114 001 114 000 000 000 000 000 000 000 000 000 000 000 000 000 000 000 000 000 000 000 000 000 000 000 000 006 001 001 007 000 000 000 000 000 000 000 000 000 000 000 000 000 000 000 000 000 000 006 050 007 000 104 100
103 107 000 000 000 006 114 114 000 000 000 000 000 000 000 000 000 000 000 000 000 000 000 000 000 000 000 000 000 000 000 000 006 001 001 007 000 000 000 000 000 000 000 000 000 000 000 000 000 000 000 000 000 000 050 001 007 000 106 102
101 105 000 000 000 114 001 007 000 000 000 000 000 000 000 000 000 000 000 000 000 000 000 000 000 000 000 000 000 000 000 000 006 001 001 007 000 000 000 000 000 000 000 000 000 000 000 000 000 000 000 000 000 000 006 001 007 000 104 100
103 107 000 000 000 006 001 007 000 000 000 000 000 000 000 000 000 000 000 000 000 000 000 000 000 000 000 000 000 000 000 000 006 001 001 007 000 000 000 000 000 000 000 000 000 000 000 000 000 000 000 000 000 000 006 001 007 000 106 102
101 105 000 000 000 006 001 001 004 004 004 004 004 004 004 004 004 004 004 004 004 004 004 004 004 004 004 004 004 004 004 004 001 001 001 001 004 004 004 004 004 004 004 004 004 004 004 004 004 004 004 004 004 004 001 001 007 000 104 100
103 107 000 000 000 008 009 009 009 009 001 001 001 009 009 009 009 009 009 009 009 009 009 009 009 009 009 009 009 009 009 009 009 009 009 009 009 009 009 009 009 009 009 009 009 009 009 009 001 001 001 009 009 009 009 009 010 000 106 102
101 105 000 000 000 000 000 000 000 000 006 001 007 000 000 000 000 000 000 000 000 000 000 000 000 000 000 000 000 000 000 000 000 000 000 000 000 000 000 000 000 000 000 000 000 000 000 000 006 001 007 000 000 000 000 000 000 000 104 100
103 107 000 000 000 000 000 000 000 000 006 001 007 000 000 000 000 000 000 000 000 000 000 000 000 000 000 000 000 000 000 000 000 000 000 000 000 000 000 000 000 000 000 000 000 000 000 000 006 001 007 000 000 000 000 000 000 000 106 102 
101 105 000 000 000 000 000 000 000 000 006 001 007 000 000 000 000 000 000 000 000 000 000 000 000 000 000 000 000 000 000 000 000 000 000 000 000 000 000 000 000 000 000 000 000 000 000 000 006 001 007 000 000 000 000 000 000 000 104 100 
103 107 000 000 000 000 000 000 000 000 006 001 007 000 000 000 000 000 000 000 000 000 000 000 000 000 000 000 000 000 000 000 000 000 000 000 000 000 000 000 000 000 000 000 000 000 000 000 006 001 007 000 000 000 000 000 000 000 106 102 
101 105 000 000 000 000 000 000 000 000 006 001 007 000 000 000 000 000 000 000 000 000 000 000 000 000 000 000 000 000 000 000 000 000 000 000 000 000 000 000 000 000 000 000 000 000 000 000 006 001 007 000 000 000 000 000 000 000 104 100 
103 107 000 000 000 000 000 000 000 000 006 001 007 000 000 000 000 000 000 000 000 000 000 000 000 000 000 000 000 000 000 000 000 000 000 000 000 000 000 000 000 000 000 000 000 000 000 000 006 001 007 000 000 000 000 000 000 000 106 102 
101 105 000 000 000 000 000 000 000 000 006 001 007 000 000 000 000 000 000 000 000 000 000 000 000 000 000 000 000 000 000 000 000 000 000 000 000 000 000 000 000 000 000 000 000 000 000 000 006 001 007 000 000 000 000 000 000 000 104 100 
103 107 000 000 000 000 000 000 000 000 006 001 007 000 000 000 000 000 000 000 000 000 000 000 000 000 000 000 000 000 000 000 000 000 000 000 000 000 000 000 000 000 000 000 000 000 000 000 006 001 007 000 000 000 000 000 000 000 106 102 
101 105 000 000 000 000 000 000 000 000 006 007 007 000 000 000 000 000 000 000 000 000 000 000 000 000 000 000 000 000 000 000 000 000 000 000 000 000 000 000 000 000 000 000 000 000 000 000 006 001 007 000 000 000 000 000 000 000 104 100 
103 107 000 000 000 000 000 000 000 000 006 001 007 000 000 000 000 000 000 000 000 000 000 000 000 000 000 000 000 000 000 000 000 000 000 000 000 000 000 000 000 000 000 000 000 000 000 000 006 001 007 000 000 000 000 000 000 000 106 102 
101 105 000 000 000 000 000 000 000 000 006 001 007 000 000 000 000 000 000 000 000 000 000 000 000 000 000 000 000 000 000 000 000 000 000 000 000 000 000 000 000 000 000 000 000 000 000 000 006 001 007 000 000 000 000 000 000 000 104 100 
103 107 000 000 000 000 000 000 000 000 006 001 007 000 000 000 000 000 000 000 000 000 000 000 000 000 000 000 000 000 000 000 000 000 000 000 000 000 000 000 000 000 000 000 000 000 000 000 006 001 007 000 000 000 000 000 000 000 106 102 
101 105 000 000 000 000 000 000 000 000 006 001 007 000 000 000 000 000 000 000 000 000 000 000 000 000 000 000 000 000 000 000 000 000 000 000 000 000 000 000 000 000 000 000 000 000 000 000 006 001 007 000 000 000 000 000 000 000 104 100 
103 107 000 000 000 000 000 000 000 000 006 001 007 000 000 000 000 000 000 000 000 000 000 000 000 000 000 000 000 000 000 000 000 000 000 000 000 000 000 000 000 000 000 000 000 000 000 000 006 001 007 000 000 000 000 000 000 000 106 102 
101 105 000 000 000 000 000 000 000 000 006 001 007 000 000 000 000 000 000 000 000 000 000 000 000 000 000 000 000 000 000 000 000 000 000 000 000 000 000 000 000 000 000 000 000 000 000 000 006 001 007 000 000 000 000 000 000 000 104 100 
103 107 000 000 039 039 039 028 028 000 006 001 007 000 000 000 003 004 004 004 005 000 000 000 000 000 000 000 000 000 000 000 000 000 000 000 000 000 000 000 000 000 000 000 000 000 000 000 006 001 007 000 000 091 092 092 092 093 106 102 
101 105 000 000 039 039 028 028 028 000 006 001 007 000 000 000 006 001 001 001 007 000 000 000 000 000 000 000 000 000 000 000 000 000 000 000 000 000 000 000 000 000 000 000 000 000 000 000 006 001 007 000 000 097 098 098 098 099 104 100 
103 107 000 000 039 039 028 028 028 000 006 001 007 000 000 000 006 001 001 001 007 000 000 000 000 000 000 000 000 000 000 000 000 000 000 000 000 000 000 000 000 000 000 000 000 000 000 000 006 001 007 000 000 000 000 000 000 000 106 102 
101 105 000 000 000 039 039 028 004 004 001 001 001 004 004 004 001 001 001 001 001 004 004 004 004 004 004 004 004 004 004 004 004 004 004 004 004 004 004 004 004 004 004 004 004 004 004 004 001 001 007 000 000 000 000 000 000 000 104 100 
103 107 000 000 000 039 028 028 009 009 009 009 009 009 009 009 009 009 009 009 009 009 009 009 009 009 009 009 009 009 009 009 009 009 009 009 009 009 009 009 009 009 009 009 009 009 009 009 009 009 010 000 000 000 000 000 000 000 106 102 
101 105 104 105 104 105 104 105 104 105 104 105 104 105 104 105 104 105 104 105 104 105 104 105 104 105 104 105 104 105 104 105 104 105 104 105 104 105 104 105 104 105 104 105 104 105 104 105 104 105 104 105 104 105 104 105 104 105 104 100 
103 102 103 102 103 102 103 102 103 102 103 102 103 102 103 102 103 102 103 102 103 102 103 102 103 102 103 102 103 102 103 102 103 102 103 102 103 102 103 102 103 102 103 102 103 102 103 102 103 102 103 102 103 102 103 102 103 102 103 102 