68 57
960 512
153 139 133 134 134 134 134 134 134 134 134 134 134 134 134 134 134 135 142 153 153 153 153 153 153 139 133 134 134 134 134 134 134 134 134 134 134 134 134 134 134 135 142 153 153 153 153 153 153 139 133 134 134 134 134 134 134 134 134 134 134 134 134 134 134 135 142 153
153 140 136 137 137 137 137 137 137 137 137 137 137 137 137 137 137 138 143 153 153 153 153 153 153 140 136 137 137 137 137 137 137 137 137 137 137 137 137 137 137 138 143 153 153 153 153 153 153 140 136 137 137 137 137 137 137 137 137 137 137 137 137 137 137 138 143 153
153 140 132 132 132 132 132 132 132 132 132 132 132 132 132 132 132 132 143 153 153 153 153 153 153 140 132 132 132 132 132 132 132 132 132 132 132 132 132 132 132 132 143 153 153 153 153 153 153 140 132 132 132 151 132 132 132 132 151 132 132 132 132 151 132 132 143 153
153 140 132 132 132 132 132 132 132 132 132 132 132 132 132 132 132 132 143 153 153 153 153 153 153 140 132 132 132 132 132 132 132 132 132 132 132 132 132 132 132 132 143 153 153 153 153 153 153 140 132 132 132 151 132 132 132 132 151 132 132 132 132 151 132 132 143 153
153 140 132 132 132 132 132 132 132 132 132 132 132 132 132 132 132 132 143 153 153 153 153 153 153 140 132 132 132 132 132 132 151 132 132 132 132 132 132 132 132 132 143 153 153 153 153 153 153 140 132 132 132 151 132 132 132 132 151 132 132 132 132 151 132 132 143 153
153 140 132 132 132 132 132 132 132 132 132 132 132 132 132 132 132 132 143 153 153 153 153 153 153 140 132 132 132 132 132 151 132 151 151 151 151 151 132 132 132 132 143 153 153 153 153 153 153 140 132 132 132 132 132 132 132 132 151 132 132 132 132 151 132 132 143 153
153 140 132 132 132 132 132 132 132 132 132 132 132 132 132 132 132 132 143 153 153 153 153 153 153 140 132 151 151 151 151 132 132 132 132 132 132 151 151 132 132 132 143 153 153 153 153 153 153 140 151 151 151 151 132 151 132 132 151 132 132 132 132 132 132 132 143 153
153 140 132 132 132 132 132 132 132 132 132 132 132 132 132 132 132 132 143 153 153 153 153 153 153 140 132 132 151 132 132 132 132 151 132 132 132 132 151 132 132 132 143 153 153 153 153 153 153 140 132 132 132 132 132 151 132 132 151 132 132 132 132 132 132 132 143 153
153 140 132 132 132 132 132 132 132 132 132 132 132 132 132 132 132 132 143 153 153 153 153 153 153 140 132 151 151 151 132 151 151 132 132 151 132 151 132 132 132 132 143 153 153 153 153 153 153 140 132 132 132 132 132 151 132 132 151 132 132 132 132 132 132 132 143 153
153 140 132 132 132 132 132 132 132 132 132 132 132 132 132 132 132 132 143 153 153 153 153 153 153 140 132 132 132 151 132 151 151 132 132 151 132 132 151 132 132 132 143 153 153 153 153 153 153 140 132 132 132 132 132 151 132 132 151 132 132 151 132 132 132 132 143 153
153 140 132 132 132 132 132 132 132 132 132 132 132 132 132 132 132 132 143 153 153 153 153 153 153 140 132 132 132 151 132 151 151 132 132 132 132 132 151 132 132 132 143 153 153 153 153 153 153 140 132 132 132 132 132 151 132 132 151 132 132 151 132 132 132 132 143 153
153 140 132 132 132 132 132 132 132 132 132 132 132 132 132 132 132 132 143 153 153 153 153 153 153 140 132 132 132 132 132 132 151 132 151 132 132 132 151 132 132 132 143 153 153 153 153 153 153 140 151 151 151 151 132 151 132 132 132 132 132 151 132 132 132 132 143 153
153 140 132 132 132 132 132 132 132 132 132 132 132 132 132 132 132 132 143 153 153 153 153 153 153 140 132 132 132 132 132 132 132 151 151 151 151 151 132 132 132 132 143 153 153 153 153 153 153 140 132 132 132 132 132 151 132 132 132 132 132 151 132 132 132 132 143 153
153 141 132 132 132 132 132 132 132 132 132 132 132 132 132 132 132 132 144 153 153 153 153 153 153 141 132 132 132 132 132 132 132 132 132 132 132 132 132 132 132 132 144 153 153 153 153 153 153 141 132 132 132 132 132 151 132 132 132 132 132 151 132 132 132 132 144 153
153 177 179 180 180 180 180 180 180 180 180 180 180 180 180 180 180 181 178 153 153 153 153 153 153 177 179 180 180 180 180 180 180 180 180 180 180 180 180 180 180 181 178 153 153 153 153 153 153 177 179 180 180 180 180 180 180 180 180 180 180 180 180 180 180 181 178 153
153 153 153 153 153 153 153 153 153 153 153 153 153 153 153 153 153 153 153 153 153 153 153 153 153 153 153 153 153 153 153 153 153 153 153 153 153 153 153 153 153 153 153 153 153 153 153 153 153 153 153 153 153 153 153 153 153 153 153 153 153 153 153 153 153 153 153 153
153 153 153 153 153 153 153 153 153 153 153 153 153 153 153 153 153 153 153 153 153 153 153 153 153 153 153 153 153 153 153 153 153 153 153 153 153 153 153 153 153 153 153 153 153 153 153 153 153 153 153 153 153 153 153 153 153 153 153 153 153 153 153 153 153 153 153 153
153 153 153 153 153 153 153 153 153 153 153 153 153 153 153 153 153 153 153 153 153 153 153 153 153 153 153 153 153 153 153 153 153 153 153 153 153 153 153 153 153 153 153 153 153 153 153 153 153 153 153 153 153 153 153 153 153 153 153 153 153 153 153 153 153 153 153 153
153 153 153 153 153 153 153 153 153 153 153 153 153 153 153 153 153 153 153 153 153 153 153 153 153 153 153 153 153 153 153 153 153 153 153 153 153 153 153 153 153 153 153 153 153 153 153 153 153 153 153 153 153 153 153 153 153 153 153 153 153 153 153 153 153 153 153 153
153 153 153 153 153 153 153 153 153 153 153 153 153 153 153 153 153 153 153 153 153 153 153 153 153 153 153 153 153 153 153 153 153 153 153 153 153 153 153 153 153 153 153 153 153 153 153 153 153 153 153 153 153 153 153 153 153 153 153 153 153 153 153 153 153 153 153 153
153 139 133 134 134 134 134 134 134 134 134 134 134 134 134 134 134 135 142 153 153 153 153 153 153 139 133 134 134 134 134 134 134 134 134 134 134 134 134 134 134 135 142 153 153 153 153 153 153 139 133 134 134 134 134 134 134 134 134 134 134 134 134 134 134 135 142 153
153 140 136 137 137 137 137 137 137 137 137 137 137 137 137 137 137 138 143 153 153 153 153 153 153 140 136 137 137 137 137 137 137 137 137 137 137 137 137 137 137 138 143 153 153 153 153 153 153 140 136 137 137 137 137 137 137 137 137 137 137 137 137 137 137 138 143 153
153 140 132 132 132 132 132 132 132 132 132 132 132 132 132 132 132 132 143 153 153 153 153 153 153 140 132 132 132 151 132 132 132 151 132 132 132 132 132 132 132 132 143 153 153 153 153 153 153 140 132 132 132 132 132 132 132 132 132 132 132 132 132 132 132 132 143 153
153 140 132 132 132 132 132 132 132 132 132 132 132 132 132 132 132 132 143 153 153 153 153 153 153 140 132 132 132 151 132 132 132 151 132 132 132 132 132 132 132 132 143 153 153 153 153 153 153 140 132 132 132 132 132 132 132 132 132 132 132 132 132 132 132 132 143 153
153 140 132 132 132 132 132 132 132 132 132 132 132 132 132 132 132 132 143 153 153 153 153 153 153 140 132 132 132 151 132 132 132 151 132 132 132 132 132 132 132 132 143 153 153 153 153 153 153 140 132 132 132 132 132 132 132 132 132 132 132 132 132 132 132 132 143 153
153 140 132 132 132 132 132 132 132 132 132 132 132 132 132 132 132 132 143 153 153 153 153 153 153 140 132 132 132 151 151 151 151 151 132 132 132 132 132 132 132 132 143 153 153 153 153 153 153 140 132 132 132 132 132 132 132 132 132 132 132 132 132 132 132 132 143 153
153 140 132 132 132 132 132 132 132 132 132 132 132 132 132 132 132 132 143 153 153 153 153 153 153 140 132 132 132 132 132 132 132 132 132 132 132 132 132 132 132 132 143 153 153 153 153 153 153 140 132 132 132 132 132 132 132 132 132 132 132 132 132 132 132 132 143 153
153 140 132 132 132 132 132 132 132 132 132 132 132 132 132 132 132 132 143 153 153 153 153 153 153 140 132 132 132 132 132 132 132 132 132 132 132 132 132 132 132 132 143 153 153 153 153 153 153 140 132 132 132 132 132 132 151 132 151 132 132 132 132 132 132 132 143 153
153 140 132 132 132 132 132 132 132 132 132 132 132 132 132 132 132 132 143 153 153 153 153 153 153 140 132 151 151 151 151 151 132 132 132 132 132 132 132 132 132 132 143 153 153 153 153 153 153 140 132 132 132 132 132 132 151 132 151 132 132 132 132 132 132 132 143 153
153 140 132 132 132 132 132 132 132 132 132 132 132 132 132 132 132 132 143 153 153 153 153 153 153 140 132 151 132 132 132 151 132 151 151 151 151 132 132 132 132 132 143 153 153 153 153 153 153 140 132 132 132 132 132 132 151 132 151 132 132 132 132 132 132 132 143 153
153 140 132 132 132 132 132 132 132 132 132 132 132 132 132 132 132 132 143 153 153 153 153 153 153 140 132 151 132 132 132 151 132 151 132 132 132 132 132 151 132 132 143 153 153 153 153 153 153 140 132 151 151 151 151 151 151 151 151 151 151 151 151 151 151 132 143 153
153 140 132 132 132 132 132 132 132 132 132 132 132 132 132 132 132 132 143 153 153 153 153 153 153 140 132 132 151 151 132 151 132 151 132 132 132 132 132 151 132 132 143 153 153 153 153 153 153 140 132 151 132 132 132 132 132 151 151 132 132 132 132 132 151 132 143 153
153 140 132 132 132 132 132 132 132 132 132 132 132 132 132 132 132 132 143 153 153 153 153 153 153 140 132 132 151 132 132 151 132 151 132 132 132 132 132 151 132 132 143 153 153 153 153 153 153 140 132 151 132 132 132 132 132 151 151 132 132 132 132 132 151 132 143 153
153 141 132 132 132 132 132 132 132 132 132 132 132 132 132 132 132 132 144 153 153 153 153 153 153 141 132 132 132 132 132 151 132 151 132 132 132 132 132 151 132 132 144 153 153 153 153 153 153 141 132 151 132 132 132 132 132 151 151 132 132 132 132 132 151 132 144 153
153 177 179 180 180 180 180 180 180 180 180 180 180 180 180 180 180 181 178 153 153 153 153 153 153 177 179 180 180 180 180 180 180 180 180 180 180 180 180 180 180 181 178 153 153 153 153 153 153 177 179 180 180 180 180 180 180 180 180 180 180 180 180 180 180 181 178 153
153 153 153 153 153 153 153 153 153 153 153 153 153 153 153 153 153 153 153 153 153 153 153 153 153 153 153 153 153 153 153 153 153 153 153 153 153 153 153 153 153 153 153 153 153 153 153 153 153 153 153 153 153 153 153 153 153 153 153 153 153 153 153 153 153 153 153 153
153 153 153 153 153 153 153 153 153 153 153 153 153 153 153 153 153 153 153 153 153 153 153 153 153 153 153 153 153 153 153 153 153 153 153 153 153 153 153 153 153 153 153 153 153 153 153 153 153 153 153 153 153 153 153 153 153 153 153 153 153 153 153 153 153 153 153 153
153 153 153 153 153 153 153 153 153 153 153 153 153 153 153 153 153 153 153 153 153 153 153 153 153 153 153 153 153 153 153 153 153 153 153 153 153 153 153 153 153 153 153 153 153 153 153 153 153 153 153 153 153 153 153 153 153 153 153 153 153 153 153 153 153 153 153 153
153 153 153 153 153 153 153 153 153 153 153 153 153 153 153 153 153 153 153 153 153 153 153 153 153 153 153 153 153 153 153 153 153 153 153 153 153 153 153 153 153 153 153 153 153 153 153 153 153 153 153 153 153 153 153 153 153 153 153 153 153 153 153 153 153 153 153 153
153 153 153 153 153 153 153 153 153 153 153 153 153 153 153 153 153 153 153 153 153 153 153 153 153 153 153 153 153 153 153 153 153 153 153 153 153 153 153 153 153 153 153 153 153 153 153 153 153 153 153 153 153 153 153 153 153 153 153 153 153 153 153 153 153 153 153 153
153 139 133 134 134 134 134 134 134 134 134 134 134 134 134 134 134 135 142 153 153 153 153 153 153 139 133 134 134 134 134 134 134 134 134 134 134 134 134 134 134 135 142 153 153 153 153 153 153 139 133 134 134 134 134 134 134 134 134 134 134 134 134 134 134 135 142 153
153 140 136 137 137 137 137 137 137 137 137 137 137 137 137 137 137 138 143 153 153 153 153 153 153 140 136 137 137 137 137 137 137 137 137 137 137 137 137 137 137 138 143 153 153 153 153 153 153 140 136 137 137 137 137 137 137 137 137 137 137 137 137 137 137 138 143 153
153 140 132 132 132 151 151 151 151 151 151 151 151 151 151 132 132 132 143 153 153 153 153 153 153 140 151 132 132 132 132 132 132 132 132 132 132 132 132 132 132 151 143 153 153 153 153 153 153 140 132 132 132 132 132 151 132 132 132 132 132 132 132 132 132 132 143 153
153 140 132 132 132 151 132 132 132 132 132 132 132 132 151 132 132 132 143 153 153 153 153 153 153 140 151 132 132 132 132 132 132 132 132 132 132 132 132 132 132 151 143 153 153 153 153 153 153 140 132 151 151 151 151 151 132 151 151 151 151 151 151 132 151 151 143 153
153 140 132 132 132 151 132 132 132 132 132 132 132 132 151 132 132 132 143 153 153 153 153 153 153 140 151 151 151 132 132 151 151 151 151 151 151 132 132 151 151 151 143 153 153 153 153 153 153 140 132 132 132 151 132 132 132 151 132 132 132 132 151 132 132 151 143 153
153 140 132 132 132 151 132 132 132 132 132 132 132 132 151 132 132 132 143 153 153 153 153 153 153 140 132 132 132 132 132 151 132 132 132 132 151 132 132 132 132 132 143 153 153 153 153 153 153 140 132 132 132 151 132 151 151 151 151 151 151 132 151 132 132 132 143 153
153 140 132 132 132 151 132 132 132 132 132 132 132 132 151 132 132 132 143 153 153 153 153 153 153 140 132 132 132 132 132 151 132 132 132 132 151 132 132 132 132 132 143 153 153 153 153 153 153 140 132 151 151 151 132 151 132 132 132 132 151 132 132 132 132 132 143 153
153 140 132 132 132 151 132 132 132 132 132 132 132 132 151 132 132 132 143 153 153 153 153 153 153 140 151 151 151 132 132 151 132 132 132 132 151 132 132 151 151 151 143 153 153 153 153 153 153 140 132 151 132 132 132 151 132 132 132 132 151 132 151 132 151 151 143 153
153 140 132 132 132 151 151 151 151 151 151 151 151 151 151 132 132 132 143 153 153 153 153 153 153 140 151 132 132 132 132 151 132 132 132 132 151 132 132 132 132 151 143 153 153 153 153 153 153 140 132 151 151 151 132 151 132 132 132 132 132 132 151 132 151 132 143 153
153 140 132 132 132 132 132 132 132 132 132 132 132 132 132 132 132 132 143 153 153 153 153 153 153 140 151 151 151 132 132 151 132 151 151 132 151 132 132 151 151 151 143 153 153 153 153 153 153 140 132 132 132 132 132 151 151 151 151 151 151 151 151 132 151 132 143 153
153 140 132 151 151 151 151 151 151 151 151 151 151 132 132 132 132 132 143 153 153 153 153 153 153 140 132 132 132 132 132 132 132 132 132 132 132 132 132 132 132 132 143 153 153 153 153 153 153 140 132 132 132 132 132 132 151 132 132 132 151 132 132 132 151 132 143 153
153 140 132 151 132 132 132 132 132 151 151 132 151 132 132 132 132 132 143 153 153 153 153 153 153 140 151 151 151 132 132 132 132 132 132 132 132 132 132 151 151 151 143 153 153 153 153 153 153 140 151 151 151 132 132 132 151 132 151 132 151 132 132 132 151 132 143 153
153 140 132 132 132 132 132 132 132 151 151 132 151 132 132 132 132 132 143 153 153 153 153 153 153 140 132 132 151 132 132 132 132 132 132 132 132 132 132 151 132 132 143 153 153 153 153 153 153 140 132 132 132 132 132 132 151 132 151 132 151 151 151 151 151 132 143 153
153 141 132 132 132 132 132 132 132 151 151 132 132 132 132 132 132 132 144 153 153 153 153 153 153 141 132 132 132 132 132 132 132 132 132 132 132 132 132 132 132 132 144 153 153 153 153 153 153 141 132 132 132 132 132 151 151 151 151 132 132 132 132 132 132 132 144 153
153 177 179 180 180 180 180 180 180 180 180 180 180 180 180 180 180 181 178 153 153 153 153 153 153 177 179 180 180 180 180 180 180 180 180 180 180 180 180 180 180 181 178 153 153 153 153 153 153 177 179 180 180 180 180 180 180 180 180 180 180 180 180 180 180 181 178 153
153 153 153 153 153 153 153 153 153 153 153 153 153 153 153 153 153 153 153 153 153 153 153 153 153 153 153 153 153 153 153 153 153 153 153 153 153 153 153 153 153 153 153 153 153 153 153 153 153 153 153 153 153 153 153 153 153 153 153 153 153 153 153 153 153 153 153 153
153 153 153 153 153 153 153 153 153 153 153 153 153 153 153 153 153 153 153 153 153 153 153 153 153 153 153 153 153 153 153 153 153 153 153 153 153 153 153 153 153 153 153 153 153 153 153 153 153 153 153 153 153 153 153 153 153 153 153 153 153 153 153 153 153 153 153 153